,Pips,Acc,Wons,Losts,Expired,Trades,Longs,Shorts,openHour,endHour,openCandles,lvlNumber,minDiff,candleMinutes,minMovement,tp,sl,waitingCandles
0,0.004259999999998353,0.34782608695652173,5,8,33,46,29,17,8,15,5,1,0.1,"[0, 20, 40]",0.0003,0.001,0.001,1
1,-0.004450000000002878,0.26436781609195403,6,10,71,87,57,30,8,15,5,1,0.1,"[0, 20, 40]",0.0003,0.001,0.001,3
2,-0.0076000000000038285,0.2358490566037736,6,11,89,106,72,34,8,15,5,1,0.1,"[0, 20, 40]",0.0003,0.001,0.001,5
3,-0.003400000000001815,0.2391304347826087,5,3,38,46,29,17,8,15,5,1,0.1,"[0, 20, 40]",0.0003,0.001,0.0015,1
4,-0.016100000000003202,0.1839080459770115,6,3,78,87,57,30,8,15,5,1,0.1,"[0, 20, 40]",0.0003,0.001,0.0015,3
5,-0.019250000000004156,0.16981132075471697,7,3,96,106,72,34,8,15,5,1,0.1,"[0, 20, 40]",0.0003,0.001,0.0015,5
6,0.002969999999998119,0.32608695652173914,0,9,37,46,29,17,8,15,5,1,0.1,"[0, 20, 40]",0.0003,0.0015,0.001,1
7,-0.0056700000000032055,0.25287356321839083,0,11,76,87,57,30,8,15,5,1,0.1,"[0, 20, 40]",0.0003,0.0015,0.001,3
8,-0.008820000000004156,0.22641509433962265,0,12,94,106,72,34,8,15,5,1,0.1,"[0, 20, 40]",0.0003,0.0015,0.001,5
9,-0.0062100000000019,0.1956521739130435,0,3,43,46,29,17,8,15,5,1,0.1,"[0, 20, 40]",0.0003,0.0015,0.0015,1
10,-0.01884000000000338,0.16091954022988506,0,3,84,87,57,30,8,15,5,1,0.1,"[0, 20, 40]",0.0003,0.0015,0.0015,3
11,-0.021890000000004458,0.1509433962264151,0,3,103,106,72,34,8,15,5,1,0.1,"[0, 20, 40]",0.0003,0.0015,0.0015,5
12,0.002969999999998119,0.32608695652173914,0,9,37,46,29,17,8,15,5,1,0.1,"[0, 20, 40]",0.0003,0.002,0.001,1
13,-0.0056700000000032055,0.25287356321839083,0,11,76,87,57,30,8,15,5,1,0.1,"[0, 20, 40]",0.0003,0.002,0.001,3
14,-0.008820000000004156,0.22641509433962265,0,12,94,106,72,34,8,15,5,1,0.1,"[0, 20, 40]",0.0003,0.002,0.001,5
15,-0.0062100000000019,0.1956521739130435,0,3,43,46,29,17,8,15,5,1,0.1,"[0, 20, 40]",0.0003,0.002,0.0015,1
16,-0.01884000000000338,0.16091954022988506,0,3,84,87,57,30,8,15,5,1,0.1,"[0, 20, 40]",0.0003,0.002,0.0015,3
17,-0.021890000000004458,0.1509433962264151,0,3,103,106,72,34,8,15,5,1,0.1,"[0, 20, 40]",0.0003,0.002,0.0015,5
18,0.000659999999999439,0.5,1,1,8,10,7,3,8,15,5,1,0.1,"[0, 20, 40]",0.0005,0.001,0.001,1
19,0.003929999999997856,0.4634146341463415,5,6,30,41,28,13,8,15,5,1,0.1,"[0, 20, 40]",0.0005,0.001,0.001,3
20,-0.0007500000000033813,0.4098360655737705,6,6,49,61,47,14,8,15,5,1,0.1,"[0, 20, 40]",0.0005,0.001,0.001,5
21,-0.0016200000000007315,0.4,1,0,9,10,7,3,8,15,5,1,0.1,"[0, 20, 40]",0.0005,0.001,0.0015,1
22,-0.00806000000000275,0.3170731707317073,5,0,36,41,28,13,8,15,5,1,0.1,"[0, 20, 40]",0.0005,0.001,0.0015,3
23,-0.012740000000003986,0.3114754098360656,6,0,55,61,47,14,8,15,5,1,0.1,"[0, 20, 40]",0.0005,0.001,0.0015,5
24,-0.0003100000000005866,0.4,0,1,9,10,7,3,8,15,5,1,0.1,"[0, 20, 40]",0.0005,0.0015,0.001,1
25,0.0023399999999977107,0.4146341463414634,1,6,34,41,28,13,8,15,5,1,0.1,"[0, 20, 40]",0.0005,0.0015,0.001,3
26,-0.0020400000000036704,0.3770491803278688,1,6,54,61,47,14,8,15,5,1,0.1,"[0, 20, 40]",0.0005,0.0015,0.001,5
27,-0.002590000000000757,0.3,0,0,10,10,7,3,8,15,5,1,0.1,"[0, 20, 40]",0.0005,0.0015,0.0015,1
28,-0.009650000000002896,0.2682926829268293,1,0,40,41,28,13,8,15,5,1,0.1,"[0, 20, 40]",0.0005,0.0015,0.0015,3
29,-0.014030000000004275,0.2786885245901639,1,0,60,61,47,14,8,15,5,1,0.1,"[0, 20, 40]",0.0005,0.0015,0.0015,5
30,-0.0003100000000005866,0.4,0,1,9,10,7,3,8,15,5,1,0.1,"[0, 20, 40]",0.0005,0.002,0.001,1
31,0.0025999999999976953,0.4146341463414634,0,6,35,41,28,13,8,15,5,1,0.1,"[0, 20, 40]",0.0005,0.002,0.001,3
32,-0.0017800000000036866,0.3770491803278688,0,6,55,61,47,14,8,15,5,1,0.1,"[0, 20, 40]",0.0005,0.002,0.001,5
33,-0.002590000000000757,0.3,0,0,10,10,7,3,8,15,5,1,0.1,"[0, 20, 40]",0.0005,0.002,0.0015,1
34,-0.009390000000002912,0.2682926829268293,0,0,41,41,28,13,8,15,5,1,0.1,"[0, 20, 40]",0.0005,0.002,0.0015,3
35,-0.013770000000004291,0.2786885245901639,0,0,61,61,47,14,8,15,5,1,0.1,"[0, 20, 40]",0.0005,0.002,0.0015,5
36,0.004419999999999446,0.4166666666666667,3,4,17,24,19,5,8,15,5,1,0.2,"[0, 20, 40]",0.0003,0.001,0.001,1
37,-0.001990000000000892,0.32558139534883723,3,5,35,43,34,9,8,15,5,1,0.2,"[0, 20, 40]",0.0003,0.001,0.001,3
38,-0.004960000000001027,0.2641509433962264,3,5,45,53,42,11,8,15,5,1,0.2,"[0, 20, 40]",0.0003,0.001,0.001,5
39,0.0018199999999993972,0.3333333333333333,3,2,19,24,19,5,8,15,5,1,0.2,"[0, 20, 40]",0.0003,0.001,0.0015,1
40,-0.006370000000000937,0.2558139534883721,3,2,38,43,34,9,8,15,5,1,0.2,"[0, 20, 40]",0.0003,0.001,0.0015,3
41,-0.009340000000001078,0.20754716981132076,3,2,48,53,42,11,8,15,5,1,0.2,"[0, 20, 40]",0.0003,0.001,0.0015,5
42,0.003069999999999375,0.375,0,4,20,24,19,5,8,15,5,1,0.2,"[0, 20, 40]",0.0003,0.0015,0.001,1
43,-0.003340000000000963,0.3023255813953488,0,5,38,43,34,9,8,15,5,1,0.2,"[0, 20, 40]",0.0003,0.0015,0.001,3
44,-0.006310000000001098,0.24528301886792453,0,5,48,53,42,11,8,15,5,1,0.2,"[0, 20, 40]",0.0003,0.0015,0.001,5
45,0.0004699999999993263,0.2916666666666667,0,2,22,24,19,5,8,15,5,1,0.2,"[0, 20, 40]",0.0003,0.0015,0.0015,1
46,-0.007720000000001008,0.23255813953488372,0,2,41,43,34,9,8,15,5,1,0.2,"[0, 20, 40]",0.0003,0.0015,0.0015,3
47,-0.01069000000000115,0.18867924528301888,0,2,51,53,42,11,8,15,5,1,0.2,"[0, 20, 40]",0.0003,0.0015,0.0015,5
48,0.003069999999999375,0.375,0,4,20,24,19,5,8,15,5,1,0.2,"[0, 20, 40]",0.0003,0.002,0.001,1
49,-0.003340000000000963,0.3023255813953488,0,5,38,43,34,9,8,15,5,1,0.2,"[0, 20, 40]",0.0003,0.002,0.001,3
50,-0.006310000000001098,0.24528301886792453,0,5,48,53,42,11,8,15,5,1,0.2,"[0, 20, 40]",0.0003,0.002,0.001,5
51,0.0004699999999993263,0.2916666666666667,0,2,22,24,19,5,8,15,5,1,0.2,"[0, 20, 40]",0.0003,0.002,0.0015,1
52,-0.007720000000001008,0.23255813953488372,0,2,41,43,34,9,8,15,5,1,0.2,"[0, 20, 40]",0.0003,0.002,0.0015,3
53,-0.01069000000000115,0.18867924528301888,0,2,51,53,42,11,8,15,5,1,0.2,"[0, 20, 40]",0.0003,0.002,0.0015,5
54,0.0016399999999996196,0.6666666666666666,0,1,5,6,5,1,8,15,5,1,0.2,"[0, 20, 40]",0.0005,0.001,0.001,1
55,0.00015999999999885008,0.4166666666666667,2,3,19,24,19,5,8,15,5,1,0.2,"[0, 20, 40]",0.0005,0.001,0.001,3
56,-0.0036200000000017082,0.35294117647058826,2,3,29,34,29,5,8,15,5,1,0.2,"[0, 20, 40]",0.0005,0.001,0.001,5
57,-0.0006400000000005502,0.5,0,0,6,6,5,1,8,15,5,1,0.2,"[0, 20, 40]",0.0005,0.001,0.0015,1
58,-0.006180000000001489,0.2916666666666667,2,0,22,24,19,5,8,15,5,1,0.2,"[0, 20, 40]",0.0005,0.001,0.0015,3
59,-0.009960000000002052,0.2647058823529412,2,0,32,34,29,5,8,15,5,1,0.2,"[0, 20, 40]",0.0005,0.001,0.0015,5
60,0.0016399999999996196,0.6666666666666666,0,1,5,6,5,1,8,15,5,1,0.2,"[0, 20, 40]",0.0005,0.0015,0.001,1
61,-0.00012000000000126344,0.375,1,3,20,24,19,5,8,15,5,1,0.2,"[0, 20, 40]",0.0005,0.0015,0.001,3
62,-0.0039000000000018217,0.3235294117647059,1,3,30,34,29,5,8,15,5,1,0.2,"[0, 20, 40]",0.0005,0.0015,0.001,5
63,-0.0006400000000005502,0.5,0,0,6,6,5,1,8,15,5,1,0.2,"[0, 20, 40]",0.0005,0.0015,0.0015,1
64,-0.0064600000000016025,0.25,1,0,23,24,19,5,8,15,5,1,0.2,"[0, 20, 40]",0.0005,0.0015,0.0015,3
65,-0.010240000000002166,0.23529411764705882,1,0,33,34,29,5,8,15,5,1,0.2,"[0, 20, 40]",0.0005,0.0015,0.0015,5
66,0.0016399999999996196,0.6666666666666666,0,1,5,6,5,1,8,15,5,1,0.2,"[0, 20, 40]",0.0005,0.002,0.001,1
67,0.00013999999999872033,0.375,0,3,21,24,19,5,8,15,5,1,0.2,"[0, 20, 40]",0.0005,0.002,0.001,3
68,-0.003640000000001839,0.3235294117647059,0,3,31,34,29,5,8,15,5,1,0.2,"[0, 20, 40]",0.0005,0.002,0.001,5
69,-0.0006400000000005502,0.5,0,0,6,6,5,1,8,15,5,1,0.2,"[0, 20, 40]",0.0005,0.002,0.0015,1
70,-0.006200000000001619,0.25,0,0,24,24,19,5,8,15,5,1,0.2,"[0, 20, 40]",0.0005,0.002,0.0015,3
71,-0.009980000000002182,0.23529411764705882,0,0,34,34,29,5,8,15,5,1,0.2,"[0, 20, 40]",0.0005,0.002,0.0015,5
72,-0.0015000000000010118,0.24242424242424243,3,3,27,33,24,9,8,15,5,2,0.1,"[0, 20, 40]",0.0003,0.001,0.001,1
73,-0.009430000000002775,0.20588235294117646,4,5,59,68,51,17,8,15,5,2,0.1,"[0, 20, 40]",0.0003,0.001,0.001,3
74,-0.011550000000003575,0.1927710843373494,4,6,73,83,64,19,8,15,5,2,0.1,"[0, 20, 40]",0.0003,0.001,0.001,5
75,-0.0027000000000011017,0.21212121212121213,3,2,28,33,24,9,8,15,5,2,0.1,"[0, 20, 40]",0.0003,0.001,0.0015,1
76,-0.014620000000003025,0.16176470588235295,4,2,62,68,51,17,8,15,5,2,0.1,"[0, 20, 40]",0.0003,0.001,0.0015,3
77,-0.016740000000003807,0.1566265060240964,5,2,76,83,64,19,8,15,5,2,0.1,"[0, 20, 40]",0.0003,0.001,0.0015,5
78,-0.003290000000001079,0.21212121212121213,0,3,30,33,24,9,8,15,5,2,0.1,"[0, 20, 40]",0.0003,0.0015,0.001,1
79,-0.011150000000002942,0.19117647058823528,0,5,63,68,51,17,8,15,5,2,0.1,"[0, 20, 40]",0.0003,0.0015,0.001,3
80,-0.01327000000000374,0.18072289156626506,0,6,77,83,64,19,8,15,5,2,0.1,"[0, 20, 40]",0.0003,0.0015,0.001,5
81,-0.0044900000000011675,0.18181818181818182,0,2,31,33,24,9,8,15,5,2,0.1,"[0, 20, 40]",0.0003,0.0015,0.0015,1
82,-0.016340000000003185,0.14705882352941177,0,2,66,68,51,17,8,15,5,2,0.1,"[0, 20, 40]",0.0003,0.0015,0.0015,3
83,-0.018360000000004085,0.14457831325301204,0,2,81,83,64,19,8,15,5,2,0.1,"[0, 20, 40]",0.0003,0.0015,0.0015,5
84,-0.003290000000001079,0.21212121212121213,0,3,30,33,24,9,8,15,5,2,0.1,"[0, 20, 40]",0.0003,0.002,0.001,1
85,-0.011150000000002942,0.19117647058823528,0,5,63,68,51,17,8,15,5,2,0.1,"[0, 20, 40]",0.0003,0.002,0.001,3
86,-0.01327000000000374,0.18072289156626506,0,6,77,83,64,19,8,15,5,2,0.1,"[0, 20, 40]",0.0003,0.002,0.001,5
87,-0.0044900000000011675,0.18181818181818182,0,2,31,33,24,9,8,15,5,2,0.1,"[0, 20, 40]",0.0003,0.002,0.0015,1
88,-0.016340000000003185,0.14705882352941177,0,2,66,68,51,17,8,15,5,2,0.1,"[0, 20, 40]",0.0003,0.002,0.0015,3
89,-0.018360000000004085,0.14457831325301204,0,2,81,83,64,19,8,15,5,2,0.1,"[0, 20, 40]",0.0003,0.002,0.0015,5
90,0.0007299999999996536,0.45454545454545453,1,1,9,11,9,2,8,15,5,2,0.1,"[0, 20, 40]",0.0005,0.001,0.001,1
91,0.0017699999999986477,0.42424242424242425,3,5,25,33,28,5,8,15,5,2,0.1,"[0, 20, 40]",0.0005,0.001,0.001,3
92,-0.000640000000002062,0.40816326530612246,4,5,40,49,44,5,8,15,5,2,0.1,"[0, 20, 40]",0.0005,0.001,0.001,5
93,-0.0015500000000005171,0.36363636363636365,1,0,10,11,9,2,8,15,5,2,0.1,"[0, 20, 40]",0.0005,0.001,0.0015,1
94,-0.008420000000002046,0.2727272727272727,3,0,30,33,28,5,8,15,5,2,0.1,"[0, 20, 40]",0.0005,0.001,0.0015,3
95,-0.010830000000002756,0.30612244897959184,4,0,45,49,44,5,8,15,5,2,0.1,"[0, 20, 40]",0.0005,0.001,0.0015,5
96,-0.00024000000000037208,0.36363636363636365,0,1,10,11,9,2,8,15,5,2,0.1,"[0, 20, 40]",0.0005,0.0015,0.001,1
97,0.00015999999999842852,0.36363636363636365,0,5,28,33,28,5,8,15,5,2,0.1,"[0, 20, 40]",0.0005,0.0015,0.001,3
98,-0.001950000000002425,0.3673469387755102,0,5,44,49,44,5,8,15,5,2,0.1,"[0, 20, 40]",0.0005,0.0015,0.001,5
99,-0.0025200000000005426,0.2727272727272727,0,0,11,11,9,2,8,15,5,2,0.1,"[0, 20, 40]",0.0005,0.0015,0.0015,1
100,-0.010030000000002266,0.21212121212121213,0,0,33,33,28,5,8,15,5,2,0.1,"[0, 20, 40]",0.0005,0.0015,0.0015,3
101,-0.01214000000000312,0.2653061224489796,0,0,49,49,44,5,8,15,5,2,0.1,"[0, 20, 40]",0.0005,0.0015,0.0015,5
102,-0.00024000000000037208,0.36363636363636365,0,1,10,11,9,2,8,15,5,2,0.1,"[0, 20, 40]",0.0005,0.002,0.001,1
103,0.00015999999999842852,0.36363636363636365,0,5,28,33,28,5,8,15,5,2,0.1,"[0, 20, 40]",0.0005,0.002,0.001,3
104,-0.001950000000002425,0.3673469387755102,0,5,44,49,44,5,8,15,5,2,0.1,"[0, 20, 40]",0.0005,0.002,0.001,5
105,-0.0025200000000005426,0.2727272727272727,0,0,11,11,9,2,8,15,5,2,0.1,"[0, 20, 40]",0.0005,0.002,0.0015,1
106,-0.010030000000002266,0.21212121212121213,0,0,33,33,28,5,8,15,5,2,0.1,"[0, 20, 40]",0.0005,0.002,0.0015,3
107,-0.01214000000000312,0.2653061224489796,0,0,49,49,44,5,8,15,5,2,0.1,"[0, 20, 40]",0.0005,0.002,0.0015,5
108,0.0006699999999996809,0.35294117647058826,3,2,12,17,16,1,8,15,5,2,0.2,"[0, 20, 40]",0.0003,0.001,0.001,1
109,-0.00490000000000112,0.2571428571428571,3,3,29,35,31,4,8,15,5,2,0.2,"[0, 20, 40]",0.0003,0.001,0.001,3
110,-0.006220000000001194,0.22727272727272727,3,4,37,44,38,6,8,15,5,2,0.2,"[0, 20, 40]",0.0003,0.001,0.001,5
111,0.0016699999999996802,0.35294117647058826,3,2,12,17,16,1,8,15,5,2,0.2,"[0, 20, 40]",0.0003,0.001,0.0015,1
112,-0.005680000000001125,0.22857142857142856,3,2,30,35,31,4,8,15,5,2,0.2,"[0, 20, 40]",0.0003,0.001,0.0015,3
113,-0.007000000000001201,0.20454545454545456,4,2,38,44,38,6,8,15,5,2,0.2,"[0, 20, 40]",0.0003,0.001,0.0015,5
114,-0.0011200000000003859,0.29411764705882354,0,2,15,17,16,1,8,15,5,2,0.2,"[0, 20, 40]",0.0003,0.0015,0.001,1
115,-0.006690000000001186,0.22857142857142856,0,3,32,35,31,4,8,15,5,2,0.2,"[0, 20, 40]",0.0003,0.0015,0.001,3
116,-0.008010000000001261,0.20454545454545456,0,4,40,44,38,6,8,15,5,2,0.2,"[0, 20, 40]",0.0003,0.0015,0.001,5
117,-0.00012000000000038651,0.29411764705882354,0,2,15,17,16,1,8,15,5,2,0.2,"[0, 20, 40]",0.0003,0.0015,0.0015,1
118,-0.007470000000001192,0.2,0,2,33,35,31,4,8,15,5,2,0.2,"[0, 20, 40]",0.0003,0.0015,0.0015,3
119,-0.00869000000000139,0.18181818181818182,0,2,42,44,38,6,8,15,5,2,0.2,"[0, 20, 40]",0.0003,0.0015,0.0015,5
120,-0.0011200000000003859,0.29411764705882354,0,2,15,17,16,1,8,15,5,2,0.2,"[0, 20, 40]",0.0003,0.002,0.001,1
121,-0.006690000000001186,0.22857142857142856,0,3,32,35,31,4,8,15,5,2,0.2,"[0, 20, 40]",0.0003,0.002,0.001,3
122,-0.008010000000001261,0.20454545454545456,0,4,40,44,38,6,8,15,5,2,0.2,"[0, 20, 40]",0.0003,0.002,0.001,5
123,-0.00012000000000038651,0.29411764705882354,0,2,15,17,16,1,8,15,5,2,0.2,"[0, 20, 40]",0.0003,0.002,0.0015,1
124,-0.007470000000001192,0.2,0,2,33,35,31,4,8,15,5,2,0.2,"[0, 20, 40]",0.0003,0.002,0.0015,3
125,-0.00869000000000139,0.18181818181818182,0,2,42,44,38,6,8,15,5,2,0.2,"[0, 20, 40]",0.0003,0.002,0.0015,5
126,-0.0002700000000002365,0.3333333333333333,0,1,5,6,6,0,8,15,5,2,0.2,"[0, 20, 40]",0.0005,0.001,0.001,1
127,5.999999999943735e-05,0.3888888888888889,2,3,13,18,17,1,8,15,5,2,0.2,"[0, 20, 40]",0.0005,0.001,0.001,3
128,-0.0015900000000010689,0.3793103448275862,3,3,23,29,28,1,8,15,5,2,0.2,"[0, 20, 40]",0.0005,0.001,0.001,5
129,-0.002550000000000407,0.16666666666666666,0,0,6,6,6,0,8,15,5,2,0.2,"[0, 20, 40]",0.0005,0.001,0.0015,1
130,-0.006280000000000904,0.2222222222222222,2,0,16,18,17,1,8,15,5,2,0.2,"[0, 20, 40]",0.0005,0.001,0.0015,3
131,-0.007930000000001412,0.27586206896551724,3,0,26,29,28,1,8,15,5,2,0.2,"[0, 20, 40]",0.0005,0.001,0.0015,5
132,-0.0002700000000002365,0.3333333333333333,0,1,5,6,6,0,8,15,5,2,0.2,"[0, 20, 40]",0.0005,0.0015,0.001,1
133,-0.0005800000000007569,0.3333333333333333,0,3,15,18,17,1,8,15,5,2,0.2,"[0, 20, 40]",0.0005,0.0015,0.001,3
134,-0.0019300000000014063,0.3448275862068966,0,3,26,29,28,1,8,15,5,2,0.2,"[0, 20, 40]",0.0005,0.0015,0.001,5
135,-0.002550000000000407,0.16666666666666666,0,0,6,6,6,0,8,15,5,2,0.2,"[0, 20, 40]",0.0005,0.0015,0.0015,1
136,-0.006920000000001098,0.16666666666666666,0,0,18,18,17,1,8,15,5,2,0.2,"[0, 20, 40]",0.0005,0.0015,0.0015,3
137,-0.00827000000000175,0.2413793103448276,0,0,29,29,28,1,8,15,5,2,0.2,"[0, 20, 40]",0.0005,0.0015,0.0015,5
138,-0.0002700000000002365,0.3333333333333333,0,1,5,6,6,0,8,15,5,2,0.2,"[0, 20, 40]",0.0005,0.002,0.001,1
139,-0.0005800000000007569,0.3333333333333333,0,3,15,18,17,1,8,15,5,2,0.2,"[0, 20, 40]",0.0005,0.002,0.001,3
140,-0.0019300000000014063,0.3448275862068966,0,3,26,29,28,1,8,15,5,2,0.2,"[0, 20, 40]",0.0005,0.002,0.001,5
141,-0.002550000000000407,0.16666666666666666,0,0,6,6,6,0,8,15,5,2,0.2,"[0, 20, 40]",0.0005,0.002,0.0015,1
142,-0.006920000000001098,0.16666666666666666,0,0,18,18,17,1,8,15,5,2,0.2,"[0, 20, 40]",0.0005,0.002,0.0015,3
143,-0.00827000000000175,0.2413793103448276,0,0,29,29,28,1,8,15,5,2,0.2,"[0, 20, 40]",0.0005,0.002,0.0015,5
144,0.011179999999998493,0.5652173913043478,10,10,26,46,29,17,8,15,10,1,0.1,"[0, 20, 40]",0.0003,0.001,0.001,1
145,0.009959999999998333,0.4659090909090909,16,17,55,88,58,30,8,15,10,1,0.1,"[0, 20, 40]",0.0003,0.001,0.001,3
146,0.014569999999997998,0.48148148148148145,19,21,68,108,74,34,8,15,10,1,0.1,"[0, 20, 40]",0.0003,0.001,0.001,5
147,0.004609999999998533,0.43478260869565216,10,4,32,46,29,17,8,15,10,1,0.1,"[0, 20, 40]",0.0003,0.001,0.0015,1
148,-4.0000000001773534e-05,0.36363636363636365,16,8,64,88,58,30,8,15,10,1,0.1,"[0, 20, 40]",0.0003,0.001,0.0015,3
149,0.0016699999999978225,0.37962962962962965,20,9,79,108,74,34,8,15,10,1,0.1,"[0, 20, 40]",0.0003,0.001,0.0015,5
150,0.012629999999998223,0.5652173913043478,4,12,30,46,29,17,8,15,10,1,0.1,"[0, 20, 40]",0.0003,0.0015,0.001,1
151,0.010849999999997731,0.4659090909090909,4,19,65,88,58,30,8,15,10,1,0.1,"[0, 20, 40]",0.0003,0.0015,0.001,3
152,0.014019999999996953,0.4722222222222222,4,23,81,108,74,34,8,15,10,1,0.1,"[0, 20, 40]",0.0003,0.0015,0.001,5
153,0.005879999999998139,0.41304347826086957,5,4,37,46,29,17,8,15,10,1,0.1,"[0, 20, 40]",0.0003,0.0015,0.0015,1
154,0.0006699999999974974,0.3522727272727273,5,8,75,88,58,30,8,15,10,1,0.1,"[0, 20, 40]",0.0003,0.0015,0.0015,3
155,0.0011999999999964734,0.3611111111111111,5,9,94,108,74,34,8,15,10,1,0.1,"[0, 20, 40]",0.0003,0.0015,0.0015,5
156,0.01229999999999806,0.5652173913043478,2,12,32,46,29,17,8,15,10,1,0.1,"[0, 20, 40]",0.0003,0.002,0.001,1
157,0.010519999999997571,0.4659090909090909,2,19,67,88,58,30,8,15,10,1,0.1,"[0, 20, 40]",0.0003,0.002,0.001,3
158,0.013689999999996795,0.4722222222222222,2,23,83,108,74,34,8,15,10,1,0.1,"[0, 20, 40]",0.0003,0.002,0.001,5
159,0.005879999999997975,0.41304347826086957,2,4,40,46,29,17,8,15,10,1,0.1,"[0, 20, 40]",0.0003,0.002,0.0015,1
160,0.0006699999999973343,0.3522727272727273,2,8,78,88,58,30,8,15,10,1,0.1,"[0, 20, 40]",0.0003,0.002,0.0015,3
161,0.0011999999999963043,0.3611111111111111,2,9,97,108,74,34,8,15,10,1,0.1,"[0, 20, 40]",0.0003,0.002,0.0015,5
162,0.003659999999999771,0.7,3,3,4,10,7,3,8,15,10,1,0.1,"[0, 20, 40]",0.0005,0.001,0.001,1
163,0.011679999999999191,0.5952380952380952,12,10,20,42,29,13,8,15,10,1,0.1,"[0, 20, 40]",0.0005,0.001,0.001,3
164,0.015879999999998156,0.5714285714285714,18,13,32,63,49,14,8,15,10,1,0.1,"[0, 20, 40]",0.0005,0.001,0.001,5
165,0.0016999999999998661,0.5,3,1,6,10,7,3,8,15,10,1,0.1,"[0, 20, 40]",0.0005,0.001,0.0015,1
166,0.007209999999999166,0.47619047619047616,12,5,25,42,29,13,8,15,10,1,0.1,"[0, 20, 40]",0.0005,0.001,0.0015,3
167,0.010969999999997898,0.47619047619047616,18,7,38,63,49,14,8,15,10,1,0.1,"[0, 20, 40]",0.0005,0.001,0.0015,5
168,0.0024299999999995415,0.5,1,3,6,10,7,3,8,15,10,1,0.1,"[0, 20, 40]",0.0005,0.0015,0.001,1
169,0.013129999999998808,0.5476190476190477,6,10,26,42,29,13,8,15,10,1,0.1,"[0, 20, 40]",0.0005,0.0015,0.001,3
170,0.01847999999999721,0.5396825396825397,8,13,42,63,49,14,8,15,10,1,0.1,"[0, 20, 40]",0.0005,0.0015,0.001,5
171,0.0004699999999996364,0.3,1,1,8,10,7,3,8,15,10,1,0.1,"[0, 20, 40]",0.0005,0.0015,0.0015,1
172,0.008659999999998782,0.42857142857142855,6,5,31,42,29,13,8,15,10,1,0.1,"[0, 20, 40]",0.0005,0.0015,0.0015,3
173,0.013569999999996946,0.4444444444444444,8,7,48,63,49,14,8,15,10,1,0.1,"[0, 20, 40]",0.0005,0.0015,0.0015,5
174,0.0029299999999995415,0.5,1,3,6,10,7,3,8,15,10,1,0.1,"[0, 20, 40]",0.0005,0.002,0.001,1
175,0.01241999999999849,0.5238095238095238,3,10,29,42,29,13,8,15,10,1,0.1,"[0, 20, 40]",0.0005,0.002,0.001,3
176,0.01780999999999682,0.5238095238095238,4,13,46,63,49,14,8,15,10,1,0.1,"[0, 20, 40]",0.0005,0.002,0.001,5
177,0.0009699999999996364,0.3,1,1,8,10,7,3,8,15,10,1,0.1,"[0, 20, 40]",0.0005,0.002,0.0015,1
178,0.007949999999998467,0.40476190476190477,3,5,34,42,29,13,8,15,10,1,0.1,"[0, 20, 40]",0.0005,0.002,0.0015,3
179,0.012899999999996555,0.42857142857142855,4,7,52,63,49,14,8,15,10,1,0.1,"[0, 20, 40]",0.0005,0.002,0.0015,5
180,0.007879999999999904,0.6666666666666666,8,5,11,24,19,5,8,15,10,1,0.2,"[0, 20, 40]",0.0003,0.001,0.001,1
181,0.0068299999999998215,0.5116279069767442,10,8,25,43,34,9,8,15,10,1,0.2,"[0, 20, 40]",0.0003,0.001,0.001,3
182,0.011399999999999643,0.5555555555555556,12,11,31,54,43,11,8,15,10,1,0.2,"[0, 20, 40]",0.0003,0.001,0.001,5
183,0.005109999999999966,0.5416666666666666,8,2,14,24,19,5,8,15,10,1,0.2,"[0, 20, 40]",0.0003,0.001,0.0015,1
184,0.0028999999999998276,0.4186046511627907,10,4,29,43,34,9,8,15,10,1,0.2,"[0, 20, 40]",0.0003,0.001,0.0015,3
185,0.004569999999999587,0.4444444444444444,12,5,37,54,43,11,8,15,10,1,0.2,"[0, 20, 40]",0.0003,0.001,0.0015,5
186,0.008829999999999635,0.6666666666666666,3,6,15,24,19,5,8,15,10,1,0.2,"[0, 20, 40]",0.0003,0.0015,0.001,1
187,0.007259999999999477,0.5116279069767442,3,9,31,43,34,9,8,15,10,1,0.2,"[0, 20, 40]",0.0003,0.0015,0.001,3
188,0.010349999999998931,0.5370370370370371,3,12,39,54,43,11,8,15,10,1,0.2,"[0, 20, 40]",0.0003,0.0015,0.001,5
189,0.0053799999999995735,0.5,3,2,19,24,19,5,8,15,10,1,0.2,"[0, 20, 40]",0.0003,0.0015,0.0015,1
190,0.0026499999999993603,0.3953488372093023,3,4,36,43,34,9,8,15,10,1,0.2,"[0, 20, 40]",0.0003,0.0015,0.0015,3
191,0.0028399999999987524,0.4074074074074074,3,5,46,54,43,11,8,15,10,1,0.2,"[0, 20, 40]",0.0003,0.0015,0.0015,5
192,0.007999999999999475,0.6666666666666666,1,6,17,24,19,5,8,15,10,1,0.2,"[0, 20, 40]",0.0003,0.002,0.001,1
193,0.006429999999999314,0.5116279069767442,1,9,33,43,34,9,8,15,10,1,0.2,"[0, 20, 40]",0.0003,0.002,0.001,3
194,0.00951999999999877,0.5370370370370371,1,12,41,54,43,11,8,15,10,1,0.2,"[0, 20, 40]",0.0003,0.002,0.001,5
195,0.0045499999999994096,0.5,1,2,21,24,19,5,8,15,10,1,0.2,"[0, 20, 40]",0.0003,0.002,0.0015,1
196,0.0018199999999991996,0.3953488372093023,1,4,38,43,34,9,8,15,10,1,0.2,"[0, 20, 40]",0.0003,0.002,0.0015,3
197,0.002009999999998591,0.4074074074074074,1,5,48,54,43,11,8,15,10,1,0.2,"[0, 20, 40]",0.0003,0.002,0.0015,5
198,0.0018,0.6666666666666666,2,1,3,6,5,1,8,15,10,1,0.2,"[0, 20, 40]",0.0005,0.001,0.001,1
199,0.005669999999999861,0.5833333333333334,7,4,13,24,19,5,8,15,10,1,0.2,"[0, 20, 40]",0.0005,0.001,0.001,3
200,0.00806999999999924,0.5714285714285714,9,7,19,35,30,5,8,15,10,1,0.2,"[0, 20, 40]",0.0005,0.001,0.001,5
201,0.0023,0.6666666666666666,2,1,3,6,5,1,8,15,10,1,0.2,"[0, 20, 40]",0.0005,0.001,0.0015,1
202,0.005169999999999747,0.5416666666666666,7,3,14,24,19,5,8,15,10,1,0.2,"[0, 20, 40]",0.0005,0.001,0.0015,3
203,0.0071299999999989054,0.5142857142857142,9,5,21,35,30,5,8,15,10,1,0.2,"[0, 20, 40]",0.0005,0.001,0.0015,5
204,0.0016799999999998249,0.5,1,1,4,6,5,1,8,15,10,1,0.2,"[0, 20, 40]",0.0005,0.0015,0.001,1
205,0.006489999999999628,0.5416666666666666,3,4,17,24,19,5,8,15,10,1,0.2,"[0, 20, 40]",0.0005,0.0015,0.001,3
206,0.008329999999998894,0.5428571428571428,3,7,25,35,30,5,8,15,10,1,0.2,"[0, 20, 40]",0.0005,0.0015,0.001,5
207,0.002179999999999825,0.5,1,1,4,6,5,1,8,15,10,1,0.2,"[0, 20, 40]",0.0005,0.0015,0.0015,1
208,0.005989999999999515,0.5,3,3,18,24,19,5,8,15,10,1,0.2,"[0, 20, 40]",0.0005,0.0015,0.0015,3
209,0.007389999999998557,0.4857142857142857,3,5,27,35,30,5,8,15,10,1,0.2,"[0, 20, 40]",0.0005,0.0015,0.0015,5
210,0.002179999999999825,0.5,1,1,4,6,5,1,8,15,10,1,0.2,"[0, 20, 40]",0.0005,0.002,0.001,1
211,0.005339999999999366,0.5,1,4,19,24,19,5,8,15,10,1,0.2,"[0, 20, 40]",0.0005,0.002,0.001,3
212,0.007179999999998633,0.5142857142857142,1,7,27,35,30,5,8,15,10,1,0.2,"[0, 20, 40]",0.0005,0.002,0.001,5
213,0.002679999999999825,0.5,1,1,4,6,5,1,8,15,10,1,0.2,"[0, 20, 40]",0.0005,0.002,0.0015,1
214,0.004839999999999255,0.4583333333333333,1,3,20,24,19,5,8,15,10,1,0.2,"[0, 20, 40]",0.0005,0.002,0.0015,3
215,0.006239999999998301,0.45714285714285713,1,5,29,35,30,5,8,15,10,1,0.2,"[0, 20, 40]",0.0005,0.002,0.0015,5
216,0.0033499999999987836,0.45454545454545453,5,5,23,33,24,9,8,15,10,2,0.1,"[0, 20, 40]",0.0003,0.001,0.001,1
217,0.005739999999997986,0.43478260869565216,11,12,46,69,52,17,8,15,10,2,0.1,"[0, 20, 40]",0.0003,0.001,0.001,3
218,0.010459999999997787,0.47058823529411764,14,16,55,85,66,19,8,15,10,2,0.1,"[0, 20, 40]",0.0003,0.001,0.001,5
219,0.0011699999999988796,0.3939393939393939,5,3,25,33,24,9,8,15,10,2,0.1,"[0, 20, 40]",0.0003,0.001,0.0015,1
220,0.0018799999999980122,0.37681159420289856,11,8,50,69,52,17,8,15,10,2,0.1,"[0, 20, 40]",0.0003,0.001,0.0015,3
221,0.0036999999999977524,0.4,15,9,61,85,66,19,8,15,10,2,0.1,"[0, 20, 40]",0.0003,0.001,0.0015,5
222,0.0033599999999987386,0.45454545454545453,2,6,25,33,24,9,8,15,10,2,0.1,"[0, 20, 40]",0.0003,0.0015,0.001,1
223,0.005689999999997774,0.43478260869565216,2,13,54,69,52,17,8,15,10,2,0.1,"[0, 20, 40]",0.0003,0.0015,0.001,3
224,0.008969999999997149,0.4588235294117647,2,17,66,85,66,19,8,15,10,2,0.1,"[0, 20, 40]",0.0003,0.0015,0.001,5
225,0.0004999999999987109,0.36363636363636365,2,3,28,33,24,9,8,15,10,2,0.1,"[0, 20, 40]",0.0003,0.0015,0.0015,1
226,0.0011499999999976772,0.36231884057971014,2,8,59,69,52,17,8,15,10,2,0.1,"[0, 20, 40]",0.0003,0.0015,0.0015,3
227,0.0017899999999967924,0.3764705882352941,2,9,74,85,66,19,8,15,10,2,0.1,"[0, 20, 40]",0.0003,0.0015,0.0015,5
228,0.0037999999999988464,0.45454545454545453,1,6,26,33,24,9,8,15,10,2,0.1,"[0, 20, 40]",0.0003,0.002,0.001,1
229,0.006129999999997882,0.43478260869565216,1,13,55,69,52,17,8,15,10,2,0.1,"[0, 20, 40]",0.0003,0.002,0.001,3
230,0.009409999999997256,0.4588235294117647,1,17,67,85,66,19,8,15,10,2,0.1,"[0, 20, 40]",0.0003,0.002,0.001,5
231,0.0009399999999988186,0.36363636363636365,1,3,29,33,24,9,8,15,10,2,0.1,"[0, 20, 40]",0.0003,0.002,0.0015,1
232,0.001589999999997785,0.36231884057971014,1,8,60,69,52,17,8,15,10,2,0.1,"[0, 20, 40]",0.0003,0.002,0.0015,3
233,0.0022299999999969003,0.3764705882352941,1,9,75,85,66,19,8,15,10,2,0.1,"[0, 20, 40]",0.0003,0.002,0.0015,5
234,0.0020299999999998405,0.5454545454545454,3,2,6,11,9,2,8,15,10,2,0.1,"[0, 20, 40]",0.0005,0.001,0.001,1
235,0.00984999999999937,0.6176470588235294,9,9,16,34,29,5,8,15,10,2,0.1,"[0, 20, 40]",0.0005,0.001,0.001,3
236,0.015439999999998642,0.6078431372549019,15,12,24,51,46,5,8,15,10,2,0.1,"[0, 20, 40]",0.0005,0.001,0.001,5
237,0.0009499999999998157,0.45454545454545453,3,1,7,11,9,2,8,15,10,2,0.1,"[0, 20, 40]",0.0005,0.001,0.0015,1
238,0.007969999999999268,0.5294117647058824,9,6,19,34,29,5,8,15,10,2,0.1,"[0, 20, 40]",0.0005,0.001,0.0015,3
239,0.013119999999998315,0.5294117647058824,15,8,28,51,46,5,8,15,10,2,0.1,"[0, 20, 40]",0.0005,0.001,0.0015,5
240,0.000799999999999611,0.36363636363636365,1,2,8,11,9,2,8,15,10,2,0.1,"[0, 20, 40]",0.0005,0.0015,0.001,1
241,0.00979999999999899,0.5588235294117647,3,9,22,34,29,5,8,15,10,2,0.1,"[0, 20, 40]",0.0005,0.0015,0.001,3
242,0.016539999999997692,0.5686274509803921,5,12,34,51,46,5,8,15,10,2,0.1,"[0, 20, 40]",0.0005,0.0015,0.001,5
243,-0.00028000000000041403,0.2727272727272727,1,1,9,11,9,2,8,15,10,2,0.1,"[0, 20, 40]",0.0005,0.0015,0.0015,1
244,0.007919999999998888,0.47058823529411764,3,6,25,34,29,5,8,15,10,2,0.1,"[0, 20, 40]",0.0005,0.0015,0.0015,3
245,0.014219999999997365,0.49019607843137253,5,8,38,51,46,5,8,15,10,2,0.1,"[0, 20, 40]",0.0005,0.0015,0.0015,5
246,0.001299999999999611,0.36363636363636365,1,2,8,11,9,2,8,15,10,2,0.1,"[0, 20, 40]",0.0005,0.002,0.001,1
247,0.010239999999998932,0.5588235294117647,2,9,23,34,29,5,8,15,10,2,0.1,"[0, 20, 40]",0.0005,0.002,0.001,3
248,0.01701999999999756,0.5686274509803921,3,12,36,51,46,5,8,15,10,2,0.1,"[0, 20, 40]",0.0005,0.002,0.001,5
249,0.00021999999999958598,0.2727272727272727,1,1,9,11,9,2,8,15,10,2,0.1,"[0, 20, 40]",0.0005,0.002,0.0015,1
250,0.008359999999998828,0.47058823529411764,2,6,26,34,29,5,8,15,10,2,0.1,"[0, 20, 40]",0.0005,0.002,0.0015,3
251,0.014699999999997233,0.49019607843137253,3,8,40,51,46,5,8,15,10,2,0.1,"[0, 20, 40]",0.0005,0.002,0.0015,5
252,0.0038799999999999456,0.6470588235294118,4,4,9,17,16,1,8,15,10,2,0.2,"[0, 20, 40]",0.0003,0.001,0.001,1
253,0.0026099999999995506,0.4857142857142857,6,7,22,35,31,4,8,15,10,2,0.2,"[0, 20, 40]",0.0003,0.001,0.001,3
254,0.007039999999999375,0.5555555555555556,7,11,27,45,39,6,8,15,10,2,0.2,"[0, 20, 40]",0.0003,0.001,0.001,5
255,0.0012000000000000422,0.5294117647058824,4,2,11,17,16,1,8,15,10,2,0.2,"[0, 20, 40]",0.0003,0.001,0.0015,1
256,-0.0012300000000004018,0.4,6,4,25,35,31,4,8,15,10,2,0.2,"[0, 20, 40]",0.0003,0.001,0.0015,3
257,0.0002999999999993505,0.4444444444444444,8,5,32,45,39,6,8,15,10,2,0.2,"[0, 20, 40]",0.0003,0.001,0.0015,5
258,0.0033899999999999013,0.6470588235294118,1,5,11,17,16,1,8,15,10,2,0.2,"[0, 20, 40]",0.0003,0.0015,0.001,1
259,0.002249999999999471,0.4857142857142857,1,8,26,35,31,4,8,15,10,2,0.2,"[0, 20, 40]",0.0003,0.0015,0.001,3
260,0.005419999999999146,0.5333333333333333,1,12,32,45,39,6,8,15,10,2,0.2,"[0, 20, 40]",0.0003,0.0015,0.001,5
261,2.99999999998732e-05,0.47058823529411764,1,2,14,17,16,1,8,15,10,2,0.2,"[0, 20, 40]",0.0003,0.0015,0.0015,1
262,-0.0022700000000006044,0.37142857142857144,1,4,30,35,31,4,8,15,10,2,0.2,"[0, 20, 40]",0.0003,0.0015,0.0015,3
263,-0.0017400000000011842,0.4,1,5,39,45,39,6,8,15,10,2,0.2,"[0, 20, 40]",0.0003,0.0015,0.0015,5
264,0.003330000000000009,0.6470588235294118,0,5,12,17,16,1,8,15,10,2,0.2,"[0, 20, 40]",0.0003,0.002,0.001,1
265,0.002189999999999579,0.4857142857142857,0,8,27,35,31,4,8,15,10,2,0.2,"[0, 20, 40]",0.0003,0.002,0.001,3
266,0.005359999999999253,0.5333333333333333,0,12,33,45,39,6,8,15,10,2,0.2,"[0, 20, 40]",0.0003,0.002,0.001,5
267,-3.000000000001897e-05,0.47058823529411764,0,2,15,17,16,1,8,15,10,2,0.2,"[0, 20, 40]",0.0003,0.002,0.0015,1
268,-0.0023300000000004966,0.37142857142857144,0,4,31,35,31,4,8,15,10,2,0.2,"[0, 20, 40]",0.0003,0.002,0.0015,3
269,-0.0018000000000010763,0.4,0,5,40,45,39,6,8,15,10,2,0.2,"[0, 20, 40]",0.0003,0.002,0.0015,5
270,0.0004899999999999676,0.5,0,2,4,6,6,0,8,15,10,2,0.2,"[0, 20, 40]",0.0005,0.001,0.001,1
271,0.0030699999999999465,0.5555555555555556,3,5,10,18,17,1,8,15,10,2,0.2,"[0, 20, 40]",0.0005,0.001,0.001,3
272,0.0067499999999994734,0.5666666666666667,7,8,15,30,29,1,8,15,10,2,0.2,"[0, 20, 40]",0.0005,0.001,0.001,5
273,-0.0005900000000000575,0.3333333333333333,0,1,5,6,6,0,8,15,10,2,0.2,"[0, 20, 40]",0.0005,0.001,0.0015,1
274,0.0009899999999998092,0.4444444444444444,3,3,12,18,17,1,8,15,10,2,0.2,"[0, 20, 40]",0.0005,0.001,0.0015,3
275,0.004229999999999115,0.4666666666666667,7,5,18,30,29,1,8,15,10,2,0.2,"[0, 20, 40]",0.0005,0.001,0.0015,5
276,0.0004899999999999676,0.5,0,2,4,6,6,0,8,15,10,2,0.2,"[0, 20, 40]",0.0005,0.0015,0.001,1
277,0.0035099999999997768,0.5555555555555556,1,5,12,18,17,1,8,15,10,2,0.2,"[0, 20, 40]",0.0005,0.0015,0.001,3
278,0.007339999999998735,0.5666666666666667,1,8,21,30,29,1,8,15,10,2,0.2,"[0, 20, 40]",0.0005,0.0015,0.001,5
279,-0.0005900000000000575,0.3333333333333333,0,1,5,6,6,0,8,15,10,2,0.2,"[0, 20, 40]",0.0005,0.0015,0.0015,1
280,0.0014299999999996397,0.4444444444444444,1,3,14,18,17,1,8,15,10,2,0.2,"[0, 20, 40]",0.0005,0.0015,0.0015,3
281,0.004819999999998379,0.4666666666666667,1,5,24,30,29,1,8,15,10,2,0.2,"[0, 20, 40]",0.0005,0.0015,0.0015,5
282,0.0004899999999999676,0.5,0,2,4,6,6,0,8,15,10,2,0.2,"[0, 20, 40]",0.0005,0.002,0.001,1
283,0.004009999999999777,0.5555555555555556,1,5,12,18,17,1,8,15,10,2,0.2,"[0, 20, 40]",0.0005,0.002,0.001,3
284,0.007839999999998733,0.5666666666666667,1,8,21,30,29,1,8,15,10,2,0.2,"[0, 20, 40]",0.0005,0.002,0.001,5
285,-0.0005900000000000575,0.3333333333333333,0,1,5,6,6,0,8,15,10,2,0.2,"[0, 20, 40]",0.0005,0.002,0.0015,1
286,0.0019299999999996395,0.4444444444444444,1,3,14,18,17,1,8,15,10,2,0.2,"[0, 20, 40]",0.0005,0.002,0.0015,3
287,0.005319999999998378,0.4666666666666667,1,5,24,30,29,1,8,15,10,2,0.2,"[0, 20, 40]",0.0005,0.002,0.0015,5
288,0.015759999999998785,0.6590909090909091,13,13,18,44,27,17,8,15,15,1,0.1,"[0, 20, 40]",0.0003,0.001,0.001,1
289,0.024289999999997664,0.6,20,25,40,85,55,30,8,15,15,1,0.1,"[0, 20, 40]",0.0003,0.001,0.001,3
290,0.030739999999997186,0.5961538461538461,25,29,50,104,70,34,8,15,15,1,0.1,"[0, 20, 40]",0.0003,0.001,0.001,5
291,0.007919999999998659,0.5227272727272727,14,5,25,44,27,17,8,15,15,1,0.1,"[0, 20, 40]",0.0003,0.001,0.0015,1
292,0.0117099999999972,0.47058823529411764,21,12,52,85,55,30,8,15,15,1,0.1,"[0, 20, 40]",0.0003,0.001,0.0015,3
293,0.016999999999996903,0.4807692307692308,27,14,63,104,70,34,8,15,15,1,0.1,"[0, 20, 40]",0.0003,0.001,0.0015,5
294,0.016969999999998105,0.6363636363636364,5,15,24,44,27,17,8,15,15,1,0.1,"[0, 20, 40]",0.0003,0.0015,0.001,1
295,0.025899999999996665,0.5764705882352941,8,27,50,85,55,30,8,15,15,1,0.1,"[0, 20, 40]",0.0003,0.0015,0.001,3
296,0.030369999999996,0.5673076923076923,8,31,65,104,70,34,8,15,15,1,0.1,"[0, 20, 40]",0.0003,0.0015,0.001,5
297,0.01012999999999787,0.5,7,5,32,44,27,17,8,15,15,1,0.1,"[0, 20, 40]",0.0003,0.0015,0.0015,1
298,0.014319999999996096,0.4470588235294118,10,12,63,85,55,30,8,15,15,1,0.1,"[0, 20, 40]",0.0003,0.0015,0.0015,3
299,0.018129999999995608,0.4519230769230769,11,14,79,104,70,34,8,15,15,1,0.1,"[0, 20, 40]",0.0003,0.0015,0.0015,5
300,0.016999999999998138,0.6136363636363636,3,15,26,44,27,17,8,15,15,1,0.1,"[0, 20, 40]",0.0003,0.002,0.001,1
301,0.026819999999996697,0.5647058823529412,5,27,53,85,55,30,8,15,15,1,0.1,"[0, 20, 40]",0.0003,0.002,0.001,3
302,0.03128999999999604,0.5576923076923077,5,31,68,104,70,34,8,15,15,1,0.1,"[0, 20, 40]",0.0003,0.002,0.001,5
303,0.010579999999998105,0.4772727272727273,3,5,36,44,27,17,8,15,15,1,0.1,"[0, 20, 40]",0.0003,0.002,0.0015,1
304,0.01565999999999633,0.43529411764705883,5,12,68,85,55,30,8,15,15,1,0.1,"[0, 20, 40]",0.0003,0.002,0.0015,3
305,0.019969999999995852,0.4423076923076923,6,14,84,104,70,34,8,15,15,1,0.1,"[0, 20, 40]",0.0003,0.002,0.0015,5
306,0.004149999999999895,0.6666666666666666,4,2,3,9,6,3,8,15,15,1,0.1,"[0, 20, 40]",0.0005,0.001,0.001,1
307,0.018219999999998866,0.6829268292682927,14,13,14,41,28,13,8,15,15,1,0.1,"[0, 20, 40]",0.0005,0.001,0.001,3
308,0.02176999999999844,0.6290322580645161,20,16,26,62,48,14,8,15,15,1,0.1,"[0, 20, 40]",0.0005,0.001,0.001,5
309,0.004649999999999895,0.6666666666666666,5,1,3,9,6,3,8,15,15,1,0.1,"[0, 20, 40]",0.0005,0.001,0.0015,1
310,0.013199999999998676,0.5609756097560976,15,7,19,41,28,13,8,15,15,1,0.1,"[0, 20, 40]",0.0005,0.001,0.0015,3
311,0.018249999999998257,0.5483870967741935,21,10,31,62,48,14,8,15,15,1,0.1,"[0, 20, 40]",0.0005,0.001,0.0015,5
312,0.0021899999999996575,0.4444444444444444,1,2,6,9,6,3,8,15,15,1,0.1,"[0, 20, 40]",0.0005,0.0015,0.001,1
313,0.01888999999999843,0.6341463414634146,7,13,21,41,28,13,8,15,15,1,0.1,"[0, 20, 40]",0.0005,0.0015,0.001,3
314,0.024329999999997947,0.5967741935483871,11,16,35,62,48,14,8,15,15,1,0.1,"[0, 20, 40]",0.0005,0.0015,0.001,5
315,0.003189999999999657,0.4444444444444444,2,1,6,9,6,3,8,15,15,1,0.1,"[0, 20, 40]",0.0005,0.0015,0.0015,1
316,0.014369999999998237,0.5121951219512195,8,7,26,41,28,13,8,15,15,1,0.1,"[0, 20, 40]",0.0005,0.0015,0.0015,3
317,0.02130999999999776,0.5161290322580645,12,10,40,62,48,14,8,15,15,1,0.1,"[0, 20, 40]",0.0005,0.0015,0.0015,5
318,0.0026899999999996575,0.4444444444444444,1,2,6,9,6,3,8,15,15,1,0.1,"[0, 20, 40]",0.0005,0.002,0.001,1
319,0.01825999999999802,0.6097560975609756,3,13,25,41,28,13,8,15,15,1,0.1,"[0, 20, 40]",0.0005,0.002,0.001,3
320,0.023599999999997335,0.5645161290322581,5,16,41,62,48,14,8,15,15,1,0.1,"[0, 20, 40]",0.0005,0.002,0.001,5
321,0.0041899999999996575,0.4444444444444444,2,1,6,9,6,3,8,15,15,1,0.1,"[0, 20, 40]",0.0005,0.002,0.0015,1
322,0.014239999999997829,0.4878048780487805,4,7,30,41,28,13,8,15,15,1,0.1,"[0, 20, 40]",0.0005,0.002,0.0015,3
323,0.02107999999999715,0.4838709677419355,6,10,46,62,48,14,8,15,15,1,0.1,"[0, 20, 40]",0.0005,0.002,0.0015,5
324,0.008819999999999334,0.7272727272727273,8,6,8,22,17,5,8,15,15,1,0.2,"[0, 20, 40]",0.0003,0.001,0.001,1
325,0.009159999999998366,0.5609756097560976,10,9,22,41,32,9,8,15,15,1,0.2,"[0, 20, 40]",0.0003,0.001,0.001,3
326,0.014259999999998243,0.5882352941176471,13,12,26,51,40,11,8,15,15,1,0.2,"[0, 20, 40]",0.0003,0.001,0.001,5
327,0.004629999999999529,0.5909090909090909,8,2,12,22,17,5,8,15,15,1,0.2,"[0, 20, 40]",0.0003,0.001,0.0015,1
328,0.004459999999998323,0.4634146341463415,10,4,27,41,32,9,8,15,15,1,0.2,"[0, 20, 40]",0.0003,0.001,0.0015,3
329,0.008399999999998376,0.49019607843137253,13,6,32,51,40,11,8,15,15,1,0.2,"[0, 20, 40]",0.0003,0.001,0.0015,5
330,0.010089999999999105,0.6818181818181818,4,7,11,22,17,5,8,15,15,1,0.2,"[0, 20, 40]",0.0003,0.0015,0.001,1
331,0.010649999999998024,0.5365853658536586,4,10,27,41,32,9,8,15,15,1,0.2,"[0, 20, 40]",0.0003,0.0015,0.001,3
332,0.014049999999997757,0.5490196078431373,4,13,34,51,40,11,8,15,15,1,0.2,"[0, 20, 40]",0.0003,0.0015,0.001,5
333,0.0058999999999991915,0.5454545454545454,4,2,16,22,17,5,8,15,15,1,0.2,"[0, 20, 40]",0.0003,0.0015,0.0015,1
334,0.005949999999997876,0.43902439024390244,4,4,33,41,32,9,8,15,15,1,0.2,"[0, 20, 40]",0.0003,0.0015,0.0015,3
335,0.008189999999997784,0.45098039215686275,4,6,41,51,40,11,8,15,15,1,0.2,"[0, 20, 40]",0.0003,0.0015,0.0015,5
336,0.009619999999999138,0.6363636363636364,2,7,13,22,17,5,8,15,15,1,0.2,"[0, 20, 40]",0.0003,0.002,0.001,1
337,0.01017999999999806,0.5121951219512195,2,10,29,41,32,9,8,15,15,1,0.2,"[0, 20, 40]",0.0003,0.002,0.001,3
338,0.013579999999997788,0.5294117647058824,2,13,36,51,40,11,8,15,15,1,0.2,"[0, 20, 40]",0.0003,0.002,0.001,5
339,0.005429999999999224,0.5,2,2,18,22,17,5,8,15,15,1,0.2,"[0, 20, 40]",0.0003,0.002,0.0015,1
340,0.005479999999997906,0.4146341463414634,2,4,35,41,32,9,8,15,15,1,0.2,"[0, 20, 40]",0.0003,0.002,0.0015,3
341,0.0077199999999978145,0.43137254901960786,2,6,43,51,40,11,8,15,15,1,0.2,"[0, 20, 40]",0.0003,0.002,0.0015,5
342,0.0017899999999999566,0.6,3,0,2,5,4,1,8,15,15,1,0.2,"[0, 20, 40]",0.0005,0.001,0.001,1
343,0.008639999999999133,0.6086956521739131,8,5,10,23,18,5,8,15,15,1,0.2,"[0, 20, 40]",0.0005,0.001,0.001,3
344,0.010469999999998772,0.5588235294117647,10,8,16,34,29,5,8,15,15,1,0.2,"[0, 20, 40]",0.0005,0.001,0.001,5
345,0.0017899999999999566,0.6,3,0,2,5,4,1,8,15,15,1,0.2,"[0, 20, 40]",0.0005,0.001,0.0015,1
346,0.0068599999999989615,0.5217391304347826,8,3,12,23,18,5,8,15,15,1,0.2,"[0, 20, 40]",0.0005,0.001,0.0015,3
347,0.010189999999998598,0.5,10,6,18,34,29,5,8,15,15,1,0.2,"[0, 20, 40]",0.0005,0.001,0.0015,5
348,0.0005399999999995959,0.4,1,0,4,5,4,1,8,15,15,1,0.2,"[0, 20, 40]",0.0005,0.0015,0.001,1
349,0.008879999999998708,0.5652173913043478,4,5,14,23,18,5,8,15,15,1,0.2,"[0, 20, 40]",0.0005,0.0015,0.001,3
350,0.010599999999998297,0.5294117647058824,4,8,22,34,29,5,8,15,15,1,0.2,"[0, 20, 40]",0.0005,0.0015,0.001,5
351,0.0005399999999995959,0.4,1,0,4,5,4,1,8,15,15,1,0.2,"[0, 20, 40]",0.0005,0.0015,0.0015,1
352,0.007099999999998535,0.4782608695652174,4,3,16,23,18,5,8,15,15,1,0.2,"[0, 20, 40]",0.0005,0.0015,0.0015,3
353,0.01031999999999812,0.47058823529411764,4,6,24,34,29,5,8,15,15,1,0.2,"[0, 20, 40]",0.0005,0.0015,0.0015,5
354,0.001039999999999596,0.4,1,0,4,5,4,1,8,15,15,1,0.2,"[0, 20, 40]",0.0005,0.002,0.001,1
355,0.008909999999998464,0.5652173913043478,1,5,17,23,18,5,8,15,15,1,0.2,"[0, 20, 40]",0.0005,0.002,0.001,3
356,0.010629999999998056,0.5294117647058824,1,8,25,34,29,5,8,15,15,1,0.2,"[0, 20, 40]",0.0005,0.002,0.001,5
357,0.001039999999999596,0.4,1,0,4,5,4,1,8,15,15,1,0.2,"[0, 20, 40]",0.0005,0.002,0.0015,1
358,0.007129999999998292,0.4782608695652174,1,3,19,23,18,5,8,15,15,1,0.2,"[0, 20, 40]",0.0005,0.002,0.0015,3
359,0.01034999999999788,0.47058823529411764,1,6,27,34,29,5,8,15,15,1,0.2,"[0, 20, 40]",0.0005,0.002,0.0015,5
360,0.004809999999999176,0.4838709677419355,8,5,18,31,22,9,8,15,15,2,0.1,"[0, 20, 40]",0.0003,0.001,0.001,1
361,0.013759999999997856,0.5303030303030303,15,15,36,66,49,17,8,15,15,2,0.1,"[0, 20, 40]",0.0003,0.001,0.001,3
362,0.01944999999999771,0.5432098765432098,19,19,43,81,62,19,8,15,15,2,0.1,"[0, 20, 40]",0.0003,0.001,0.001,5
363,0.005249999999999281,0.45161290322580644,8,4,19,31,22,9,8,15,15,2,0.1,"[0, 20, 40]",0.0003,0.001,0.0015,1
364,0.012439999999997576,0.4696969696969697,15,11,40,66,49,17,8,15,15,2,0.1,"[0, 20, 40]",0.0003,0.001,0.0015,3
365,0.016969999999997605,0.48148148148148145,20,13,48,81,62,19,8,15,15,2,0.1,"[0, 20, 40]",0.0003,0.001,0.0015,5
366,0.00422999999999871,0.45161290322580644,2,6,23,31,22,9,8,15,15,2,0.1,"[0, 20, 40]",0.0003,0.0015,0.001,1
367,0.013779999999997046,0.5,5,16,45,66,49,17,8,15,15,2,0.1,"[0, 20, 40]",0.0003,0.0015,0.001,3
368,0.0177099999999967,0.5061728395061729,5,20,56,81,62,19,8,15,15,2,0.1,"[0, 20, 40]",0.0003,0.0015,0.001,5
369,0.004669999999998706,0.41935483870967744,2,4,25,31,22,9,8,15,15,2,0.1,"[0, 20, 40]",0.0003,0.0015,0.0015,1
370,0.012459999999996656,0.4393939393939394,5,11,50,66,49,17,8,15,15,2,0.1,"[0, 20, 40]",0.0003,0.0015,0.0015,3
371,0.015729999999996486,0.4444444444444444,6,13,62,81,62,19,8,15,15,2,0.1,"[0, 20, 40]",0.0003,0.0015,0.0015,5
372,0.00522999999999871,0.45161290322580644,2,6,23,31,22,9,8,15,15,2,0.1,"[0, 20, 40]",0.0003,0.002,0.001,1
373,0.015669999999997044,0.5,4,16,46,66,49,17,8,15,15,2,0.1,"[0, 20, 40]",0.0003,0.002,0.001,3
374,0.019599999999996703,0.5061728395061729,4,20,57,81,62,19,8,15,15,2,0.1,"[0, 20, 40]",0.0003,0.002,0.001,5
375,0.005669999999998706,0.41935483870967744,2,4,25,31,22,9,8,15,15,2,0.1,"[0, 20, 40]",0.0003,0.002,0.0015,1
376,0.014349999999996659,0.4393939393939394,4,11,51,66,49,17,8,15,15,2,0.1,"[0, 20, 40]",0.0003,0.002,0.0015,3
377,0.018119999999996486,0.4444444444444444,5,13,63,81,62,19,8,15,15,2,0.1,"[0, 20, 40]",0.0003,0.002,0.0015,5
378,0.00295999999999996,0.5,4,1,5,10,8,2,8,15,15,2,0.1,"[0, 20, 40]",0.0005,0.001,0.001,1
379,0.013989999999999317,0.6363636363636364,11,10,12,33,28,5,8,15,15,2,0.1,"[0, 20, 40]",0.0005,0.001,0.001,3
380,0.020079999999998974,0.64,17,13,20,50,45,5,8,15,15,2,0.1,"[0, 20, 40]",0.0005,0.001,0.001,5
381,0.0034599999999999596,0.5,4,1,5,10,8,2,8,15,15,2,0.1,"[0, 20, 40]",0.0005,0.001,0.0015,1
382,0.012479999999999025,0.5454545454545454,11,7,15,33,28,5,8,15,15,2,0.1,"[0, 20, 40]",0.0005,0.001,0.0015,3
383,0.020069999999998683,0.58,17,10,23,50,45,5,8,15,15,2,0.1,"[0, 20, 40]",0.0005,0.001,0.0015,5
384,0.000999999999999723,0.3,1,1,8,10,8,2,8,15,15,2,0.1,"[0, 20, 40]",0.0005,0.0015,0.001,1
385,0.013159999999998876,0.5757575757575758,4,10,19,33,28,5,8,15,15,2,0.1,"[0, 20, 40]",0.0005,0.0015,0.001,3
386,0.021139999999998473,0.6,8,13,29,50,45,5,8,15,15,2,0.1,"[0, 20, 40]",0.0005,0.0015,0.001,5
387,0.0014999999999997227,0.3,1,1,8,10,8,2,8,15,15,2,0.1,"[0, 20, 40]",0.0005,0.0015,0.0015,1
388,0.011649999999998587,0.48484848484848486,4,7,22,33,28,5,8,15,15,2,0.1,"[0, 20, 40]",0.0005,0.0015,0.0015,3
389,0.02112999999999819,0.54,8,10,32,50,45,5,8,15,15,2,0.1,"[0, 20, 40]",0.0005,0.0015,0.0015,5
390,0.001499999999999723,0.3,1,1,8,10,8,2,8,15,15,2,0.1,"[0, 20, 40]",0.0005,0.002,0.001,1
391,0.012399999999998784,0.5454545454545454,2,10,21,33,28,5,8,15,15,2,0.1,"[0, 20, 40]",0.0005,0.002,0.001,3
392,0.02027999999999818,0.56,4,13,33,50,45,5,8,15,15,2,0.1,"[0, 20, 40]",0.0005,0.002,0.001,5
393,0.001999999999999723,0.3,1,1,8,10,8,2,8,15,15,2,0.1,"[0, 20, 40]",0.0005,0.002,0.0015,1
394,0.010889999999998493,0.45454545454545453,2,7,24,33,28,5,8,15,15,2,0.1,"[0, 20, 40]",0.0005,0.002,0.0015,3
395,0.020269999999997894,0.5,4,10,36,50,45,5,8,15,15,2,0.1,"[0, 20, 40]",0.0005,0.002,0.0015,5
396,0.005759999999999762,0.6666666666666666,5,4,6,15,14,1,8,15,15,2,0.2,"[0, 20, 40]",0.0003,0.001,0.001,1
397,0.008209999999998871,0.5757575757575758,7,9,17,33,29,4,8,15,15,2,0.2,"[0, 20, 40]",0.0003,0.001,0.001,3
398,0.013449999999998801,0.6190476190476191,9,13,20,42,36,6,8,15,15,2,0.2,"[0, 20, 40]",0.0003,0.001,0.001,5
399,0.005699999999999867,0.6,5,3,7,15,14,1,8,15,15,2,0.2,"[0, 20, 40]",0.0003,0.001,0.0015,1
400,0.006209999999998641,0.48484848484848486,7,6,20,33,29,4,8,15,15,2,0.2,"[0, 20, 40]",0.0003,0.001,0.0015,3
401,0.010289999999998741,0.5238095238095238,10,8,24,42,36,6,8,15,15,2,0.2,"[0, 20, 40]",0.0003,0.001,0.0015,5
402,0.005289999999999515,0.6,1,5,9,15,14,1,8,15,15,2,0.2,"[0, 20, 40]",0.0003,0.0015,0.001,1
403,0.007219999999998495,0.5151515151515151,2,10,21,33,29,4,8,15,15,2,0.2,"[0, 20, 40]",0.0003,0.0015,0.001,3
404,0.01077999999999852,0.5476190476190477,2,14,26,42,36,6,8,15,15,2,0.2,"[0, 20, 40]",0.0003,0.0015,0.001,5
405,0.00522999999999951,0.5333333333333333,1,3,11,15,14,1,8,15,15,2,0.2,"[0, 20, 40]",0.0003,0.0015,0.0015,1
406,0.005219999999998153,0.42424242424242425,2,6,25,33,29,4,8,15,15,2,0.2,"[0, 20, 40]",0.0003,0.0015,0.0015,3
407,0.008119999999998354,0.4523809523809524,3,8,31,42,36,6,8,15,15,2,0.2,"[0, 20, 40]",0.0003,0.0015,0.0015,5
408,0.005789999999999514,0.6,1,5,9,15,14,1,8,15,15,2,0.2,"[0, 20, 40]",0.0003,0.002,0.001,1
409,0.008219999999998496,0.5151515151515151,2,10,21,33,29,4,8,15,15,2,0.2,"[0, 20, 40]",0.0003,0.002,0.001,3
410,0.011779999999998519,0.5476190476190477,2,14,26,42,36,6,8,15,15,2,0.2,"[0, 20, 40]",0.0003,0.002,0.001,5
411,0.00572999999999951,0.5333333333333333,1,3,11,15,14,1,8,15,15,2,0.2,"[0, 20, 40]",0.0003,0.002,0.0015,1
412,0.006219999999998154,0.42424242424242425,2,6,25,33,29,4,8,15,15,2,0.2,"[0, 20, 40]",0.0003,0.002,0.0015,3
413,0.009619999999998354,0.4523809523809524,3,8,31,42,36,6,8,15,15,2,0.2,"[0, 20, 40]",0.0003,0.002,0.0015,5
414,0.0007899999999999566,0.4,1,1,3,5,5,0,8,15,15,2,0.2,"[0, 20, 40]",0.0005,0.001,0.001,1
415,0.005529999999999543,0.5294117647058824,4,5,8,17,16,1,8,15,15,2,0.2,"[0, 20, 40]",0.0005,0.001,0.001,3
416,0.00924999999999933,0.5517241379310345,8,8,13,29,28,1,8,15,15,2,0.2,"[0, 20, 40]",0.0005,0.001,0.001,5
417,0.0012899999999999565,0.4,1,1,3,5,5,0,8,15,15,2,0.2,"[0, 20, 40]",0.0005,0.001,0.0015,1
418,0.006219999999999287,0.47058823529411764,4,4,9,17,16,1,8,15,15,2,0.2,"[0, 20, 40]",0.0005,0.001,0.0015,3
419,0.011439999999999072,0.5172413793103449,8,7,14,29,28,1,8,15,15,2,0.2,"[0, 20, 40]",0.0005,0.001,0.0015,5
420,0.000739999999999741,0.4,0,1,4,5,5,0,8,15,15,2,0.2,"[0, 20, 40]",0.0005,0.0015,0.001,1
421,0.005969999999999262,0.5294117647058824,1,5,11,17,16,1,8,15,15,2,0.2,"[0, 20, 40]",0.0005,0.0015,0.001,3
422,0.010579999999998996,0.5517241379310345,3,8,18,29,28,1,8,15,15,2,0.2,"[0, 20, 40]",0.0005,0.0015,0.001,5
423,0.0012399999999997409,0.4,0,1,4,5,5,0,8,15,15,2,0.2,"[0, 20, 40]",0.0005,0.0015,0.0015,1
424,0.006659999999999007,0.47058823529411764,1,4,12,17,16,1,8,15,15,2,0.2,"[0, 20, 40]",0.0005,0.0015,0.0015,3
425,0.01276999999999874,0.5172413793103449,3,7,19,29,28,1,8,15,15,2,0.2,"[0, 20, 40]",0.0005,0.0015,0.0015,5
426,0.000739999999999741,0.4,0,1,4,5,5,0,8,15,15,2,0.2,"[0, 20, 40]",0.0005,0.002,0.001,1
427,0.0064699999999992645,0.5294117647058824,1,5,11,17,16,1,8,15,15,2,0.2,"[0, 20, 40]",0.0005,0.002,0.001,3
428,0.01181999999999885,0.5517241379310345,2,8,19,29,28,1,8,15,15,2,0.2,"[0, 20, 40]",0.0005,0.002,0.001,5
429,0.0012399999999997409,0.4,0,1,4,5,5,0,8,15,15,2,0.2,"[0, 20, 40]",0.0005,0.002,0.0015,1
430,0.0071599999999990074,0.47058823529411764,1,4,12,17,16,1,8,15,15,2,0.2,"[0, 20, 40]",0.0005,0.002,0.0015,3
431,0.014009999999998593,0.5172413793103449,2,7,20,29,28,1,8,15,15,2,0.2,"[0, 20, 40]",0.0005,0.002,0.0015,5
432,0.02464000000000001,0.7441860465116279,16,15,12,43,27,16,8,15,20,1,0.1,"[0, 20, 40]",0.0003,0.001,0.001,1
433,0.03760000000000001,0.7272727272727273,22,29,26,77,50,27,8,15,20,1,0.1,"[0, 20, 40]",0.0003,0.001,0.001,3
434,0.04501999999999983,0.7263157894736842,29,34,32,95,64,31,8,15,20,1,0.1,"[0, 20, 40]",0.0003,0.001,0.001,5
435,0.02120999999999992,0.627906976744186,17,9,17,43,27,16,8,15,20,1,0.1,"[0, 20, 40]",0.0003,0.001,0.0015,1
436,0.024859999999999917,0.5584415584415584,22,16,39,77,50,27,8,15,20,1,0.1,"[0, 20, 40]",0.0003,0.001,0.0015,3
437,0.034069999999999684,0.5851063829787234,30,20,44,94,63,31,8,15,20,1,0.1,"[0, 20, 40]",0.0003,0.001,0.0015,5
438,0.030389999999999646,0.7209302325581395,9,17,17,43,27,16,8,15,20,1,0.1,"[0, 20, 40]",0.0003,0.0015,0.001,1
439,0.04452999999999937,0.7012987012987013,12,32,33,77,50,27,8,15,20,1,0.1,"[0, 20, 40]",0.0003,0.0015,0.001,3
440,0.05193999999999895,0.6947368421052632,15,38,42,95,64,31,8,15,20,1,0.1,"[0, 20, 40]",0.0003,0.0015,0.001,5
441,0.02845999999999955,0.6046511627906976,12,9,22,43,27,16,8,15,20,1,0.1,"[0, 20, 40]",0.0003,0.0015,0.0015,1
442,0.03328999999999926,0.5324675324675324,14,17,46,77,50,27,8,15,20,1,0.1,"[0, 20, 40]",0.0003,0.0015,0.0015,3
443,0.04142999999999871,0.5425531914893617,18,21,55,94,63,31,8,15,20,1,0.1,"[0, 20, 40]",0.0003,0.0015,0.0015,5
444,0.031309999999999304,0.7209302325581395,4,17,22,43,27,16,8,15,20,1,0.1,"[0, 20, 40]",0.0003,0.002,0.001,1
445,0.046999999999999126,0.7012987012987013,7,32,38,77,50,27,8,15,20,1,0.1,"[0, 20, 40]",0.0003,0.002,0.001,3
446,0.052339999999998554,0.6914893617021277,7,37,50,94,64,30,8,15,20,1,0.1,"[0, 20, 40]",0.0003,0.002,0.001,5
447,0.030089999999999364,0.6046511627906976,6,9,28,43,27,16,8,15,20,1,0.1,"[0, 20, 40]",0.0003,0.002,0.0015,1
448,0.03675999999999903,0.5324675324675324,9,17,51,77,50,27,8,15,20,1,0.1,"[0, 20, 40]",0.0003,0.002,0.0015,3
449,0.04282999999999832,0.5376344086021505,10,20,63,93,63,30,8,15,20,1,0.1,"[0, 20, 40]",0.0003,0.002,0.0015,5
450,0.004939999999999852,0.7777777777777778,4,3,2,9,6,3,8,15,20,1,0.1,"[0, 20, 40]",0.0005,0.001,0.001,1
451,0.017879999999999462,0.717948717948718,13,13,13,39,27,12,8,15,20,1,0.1,"[0, 20, 40]",0.0005,0.001,0.001,3
452,0.024489999999999356,0.7068965517241379,18,19,21,58,45,13,8,15,20,1,0.1,"[0, 20, 40]",0.0005,0.001,0.001,5
453,0.003659999999999848,0.6666666666666666,5,1,3,9,6,3,8,15,20,1,0.1,"[0, 20, 40]",0.0005,0.001,0.0015,1
454,0.015429999999999304,0.6052631578947368,13,8,17,38,26,12,8,15,20,1,0.1,"[0, 20, 40]",0.0005,0.001,0.0015,3
455,0.019739999999999192,0.5964912280701754,19,11,27,57,44,13,8,15,20,1,0.1,"[0, 20, 40]",0.0005,0.001,0.0015,5
456,0.004519999999999821,0.6666666666666666,1,4,4,9,6,3,8,15,20,1,0.1,"[0, 20, 40]",0.0005,0.0015,0.001,1
457,0.020419999999999446,0.6923076923076923,8,14,17,39,27,12,8,15,20,1,0.1,"[0, 20, 40]",0.0005,0.0015,0.001,3
458,0.028879999999999136,0.6896551724137931,12,20,26,58,45,13,8,15,20,1,0.1,"[0, 20, 40]",0.0005,0.0015,0.001,5
459,0.0019199999999997748,0.4444444444444444,2,1,6,9,6,3,8,15,20,1,0.1,"[0, 20, 40]",0.0005,0.0015,0.0015,1
460,0.016149999999999245,0.5526315789473685,8,8,22,38,26,12,8,15,20,1,0.1,"[0, 20, 40]",0.0005,0.0015,0.0015,3
461,0.022809999999998925,0.5614035087719298,13,11,33,57,44,13,8,15,20,1,0.1,"[0, 20, 40]",0.0005,0.0015,0.0015,5
462,0.005019999999999821,0.6666666666666666,1,4,4,9,6,3,8,15,20,1,0.1,"[0, 20, 40]",0.0005,0.002,0.001,1
463,0.022039999999998953,0.6923076923076923,5,14,20,39,27,12,8,15,20,1,0.1,"[0, 20, 40]",0.0005,0.002,0.001,3
464,0.03209999999999848,0.6896551724137931,8,20,30,58,45,13,8,15,20,1,0.1,"[0, 20, 40]",0.0005,0.002,0.001,5
465,0.0029199999999997748,0.4444444444444444,2,1,6,9,6,3,8,15,20,1,0.1,"[0, 20, 40]",0.0005,0.002,0.0015,1
466,0.01912999999999901,0.5526315789473685,6,8,24,38,26,12,8,15,20,1,0.1,"[0, 20, 40]",0.0005,0.002,0.0015,3
467,0.02788999999999852,0.5614035087719298,10,11,36,57,44,13,8,15,20,1,0.1,"[0, 20, 40]",0.0005,0.002,0.0015,5
468,0.012130000000000031,0.7727272727272727,10,7,5,22,17,5,8,15,20,1,0.2,"[0, 20, 40]",0.0003,0.001,0.001,1
469,0.016480000000000303,0.7105263157894737,12,12,14,38,29,9,8,15,20,1,0.2,"[0, 20, 40]",0.0003,0.001,0.001,3
470,0.021130000000000475,0.723404255319149,16,15,16,47,36,11,8,15,20,1,0.2,"[0, 20, 40]",0.0003,0.001,0.001,5
471,0.009549999999999894,0.6363636363636364,10,4,8,22,17,5,8,15,20,1,0.2,"[0, 20, 40]",0.0003,0.001,0.0015,1
472,0.012170000000000103,0.5789473684210527,12,7,19,38,29,9,8,15,20,1,0.2,"[0, 20, 40]",0.0003,0.001,0.0015,3
473,0.01832000000000027,0.6170212765957447,16,10,21,47,36,11,8,15,20,1,0.2,"[0, 20, 40]",0.0003,0.001,0.0015,5
474,0.014859999999999872,0.7727272727272727,7,8,7,22,17,5,8,15,20,1,0.2,"[0, 20, 40]",0.0003,0.0015,0.001,1
475,0.019579999999999903,0.7105263157894737,7,13,18,38,29,9,8,15,20,1,0.2,"[0, 20, 40]",0.0003,0.0015,0.001,3
476,0.024730000000000016,0.723404255319149,9,17,21,47,36,11,8,15,20,1,0.2,"[0, 20, 40]",0.0003,0.0015,0.001,5
477,0.012779999999999733,0.6363636363636364,8,4,10,22,17,5,8,15,20,1,0.2,"[0, 20, 40]",0.0003,0.0015,0.0015,1
478,0.015769999999999704,0.5789473684210527,8,7,23,38,29,9,8,15,20,1,0.2,"[0, 20, 40]",0.0003,0.0015,0.0015,3
479,0.020859999999999698,0.5957446808510638,10,10,27,47,36,11,8,15,20,1,0.2,"[0, 20, 40]",0.0003,0.0015,0.0015,5
480,0.015339999999999635,0.7727272727272727,3,8,11,22,17,5,8,15,20,1,0.2,"[0, 20, 40]",0.0003,0.002,0.001,1
481,0.021099999999999813,0.7105263157894737,4,13,21,38,29,9,8,15,20,1,0.2,"[0, 20, 40]",0.0003,0.002,0.001,3
482,0.024459999999999777,0.717391304347826,4,16,26,46,36,10,8,15,20,1,0.2,"[0, 20, 40]",0.0003,0.002,0.001,5
483,0.013759999999999495,0.6363636363636364,4,4,14,22,17,5,8,15,20,1,0.2,"[0, 20, 40]",0.0003,0.002,0.0015,1
484,0.017789999999999615,0.5789473684210527,5,7,26,38,29,9,8,15,20,1,0.2,"[0, 20, 40]",0.0003,0.002,0.0015,3
485,0.02058999999999946,0.5869565217391305,5,9,32,46,36,10,8,15,20,1,0.2,"[0, 20, 40]",0.0003,0.002,0.0015,5
486,0.0030899999999999235,0.8,3,1,1,5,4,1,8,15,20,1,0.2,"[0, 20, 40]",0.0005,0.001,0.001,1
487,0.010729999999999835,0.6956521739130435,8,6,9,23,18,5,8,15,20,1,0.2,"[0, 20, 40]",0.0005,0.001,0.001,3
488,0.013899999999999949,0.696969696969697,10,10,13,33,28,5,8,15,20,1,0.2,"[0, 20, 40]",0.0005,0.001,0.001,5
489,0.0013099999999999206,0.6,3,0,2,5,4,1,8,15,20,1,0.2,"[0, 20, 40]",0.0005,0.001,0.0015,1
490,0.009939999999999763,0.6086956521739131,8,4,11,23,18,5,8,15,20,1,0.2,"[0, 20, 40]",0.0005,0.001,0.0015,3
491,0.012849999999999782,0.6060606060606061,10,7,16,33,28,5,8,15,20,1,0.2,"[0, 20, 40]",0.0005,0.001,0.0015,5
492,0.00341999999999981,0.8,1,2,2,5,4,1,8,15,20,1,0.2,"[0, 20, 40]",0.0005,0.0015,0.001,1
493,0.012939999999999709,0.6956521739130435,5,7,11,23,18,5,8,15,20,1,0.2,"[0, 20, 40]",0.0005,0.0015,0.001,3
494,0.016199999999999527,0.696969696969697,5,11,17,33,28,5,8,15,20,1,0.2,"[0, 20, 40]",0.0005,0.0015,0.001,5
495,-0.0001800000000002364,0.4,1,0,4,5,4,1,8,15,20,1,0.2,"[0, 20, 40]",0.0005,0.0015,0.0015,1
496,0.010329999999999596,0.5652173913043478,5,4,14,23,18,5,8,15,20,1,0.2,"[0, 20, 40]",0.0005,0.0015,0.0015,3
497,0.013329999999999315,0.5757575757575758,5,7,21,33,28,5,8,15,20,1,0.2,"[0, 20, 40]",0.0005,0.0015,0.0015,5
498,0.00391999999999981,0.8,1,2,2,5,4,1,8,15,20,1,0.2,"[0, 20, 40]",0.0005,0.002,0.001,1
499,0.014419999999999471,0.6956521739130435,3,7,13,23,18,5,8,15,20,1,0.2,"[0, 20, 40]",0.0005,0.002,0.001,3
500,0.017679999999999287,0.696969696969697,3,11,19,33,28,5,8,15,20,1,0.2,"[0, 20, 40]",0.0005,0.002,0.001,5
501,0.0003199999999997636,0.4,1,0,4,5,4,1,8,15,20,1,0.2,"[0, 20, 40]",0.0005,0.002,0.0015,1
502,0.011809999999999357,0.5652173913043478,3,4,16,23,18,5,8,15,20,1,0.2,"[0, 20, 40]",0.0005,0.002,0.0015,3
503,0.014809999999999077,0.5757575757575758,3,7,23,33,28,5,8,15,20,1,0.2,"[0, 20, 40]",0.0005,0.002,0.0015,5
504,0.01396000000000019,0.6333333333333333,10,8,12,30,22,8,8,15,20,2,0.1,"[0, 20, 40]",0.0003,0.001,0.001,1
505,0.025499999999999936,0.65,16,19,25,60,45,15,8,15,20,2,0.1,"[0, 20, 40]",0.0003,0.001,0.001,3
506,0.03231000000000015,0.6756756756756757,22,24,28,74,57,17,8,15,20,2,0.1,"[0, 20, 40]",0.0003,0.001,0.001,5
507,0.015480000000000205,0.6,10,7,13,30,22,8,8,15,20,2,0.1,"[0, 20, 40]",0.0003,0.001,0.0015,1
508,0.026519999999999905,0.5833333333333334,16,15,29,60,45,15,8,15,20,2,0.1,"[0, 20, 40]",0.0003,0.001,0.0015,3
509,0.0351200000000001,0.6164383561643836,23,19,31,73,56,17,8,15,20,2,0.1,"[0, 20, 40]",0.0003,0.001,0.0015,5
510,0.017209999999999823,0.6,4,9,17,30,22,8,8,15,20,2,0.1,"[0, 20, 40]",0.0003,0.0015,0.001,1
511,0.028759999999999203,0.6166666666666667,6,21,33,60,45,15,8,15,20,2,0.1,"[0, 20, 40]",0.0003,0.0015,0.001,3
512,0.036219999999999204,0.6486486486486487,9,27,38,74,57,17,8,15,20,2,0.1,"[0, 20, 40]",0.0003,0.0015,0.001,5
513,0.019229999999999838,0.5666666666666667,5,7,18,30,22,8,8,15,20,2,0.1,"[0, 20, 40]",0.0003,0.0015,0.0015,1
514,0.030779999999999155,0.55,7,16,37,60,45,15,8,15,20,2,0.1,"[0, 20, 40]",0.0003,0.0015,0.0015,3
515,0.038969999999999026,0.5753424657534246,11,20,42,73,56,17,8,15,20,2,0.1,"[0, 20, 40]",0.0003,0.0015,0.0015,5
516,0.018649999999999705,0.6,3,9,18,30,22,8,8,15,20,2,0.1,"[0, 20, 40]",0.0003,0.002,0.001,1
517,0.030209999999999043,0.6166666666666667,4,21,35,60,45,15,8,15,20,2,0.1,"[0, 20, 40]",0.0003,0.002,0.001,3
518,0.03639999999999889,0.6486486486486487,4,27,43,74,57,17,8,15,20,2,0.1,"[0, 20, 40]",0.0003,0.002,0.001,5
519,0.021169999999999724,0.5666666666666667,4,7,19,30,22,8,8,15,20,2,0.1,"[0, 20, 40]",0.0003,0.002,0.0015,1
520,0.032729999999999,0.55,5,16,39,60,45,15,8,15,20,2,0.1,"[0, 20, 40]",0.0003,0.002,0.0015,3
521,0.04014999999999871,0.5753424657534246,6,20,47,73,56,17,8,15,20,2,0.1,"[0, 20, 40]",0.0003,0.002,0.0015,5
522,0.005059999999999949,0.7,4,3,3,10,8,2,8,15,20,2,0.1,"[0, 20, 40]",0.0005,0.001,0.001,1
523,0.01638999999999985,0.75,10,12,10,32,27,5,8,15,20,2,0.1,"[0, 20, 40]",0.0005,0.001,0.001,3
524,0.02282999999999993,0.7291666666666666,16,16,16,48,43,5,8,15,20,2,0.1,"[0, 20, 40]",0.0005,0.001,0.001,5
525,0.004279999999999946,0.6,4,2,4,10,8,2,8,15,20,2,0.1,"[0, 20, 40]",0.0005,0.001,0.0015,1
526,0.016079999999999667,0.6451612903225806,9,9,13,31,26,5,8,15,20,2,0.1,"[0, 20, 40]",0.0005,0.001,0.0015,3
527,0.022259999999999662,0.6382978723404256,15,12,20,47,42,5,8,15,20,2,0.1,"[0, 20, 40]",0.0005,0.001,0.0015,5
528,0.0046399999999999185,0.6,1,4,5,10,8,2,8,15,20,2,0.1,"[0, 20, 40]",0.0005,0.0015,0.001,1
529,0.017429999999999835,0.71875,5,13,14,32,27,5,8,15,20,2,0.1,"[0, 20, 40]",0.0005,0.0015,0.001,3
530,0.025959999999999615,0.7083333333333334,9,17,22,48,43,5,8,15,20,2,0.1,"[0, 20, 40]",0.0005,0.0015,0.001,5
531,0.0020399999999998726,0.4,1,2,7,10,8,2,8,15,20,2,0.1,"[0, 20, 40]",0.0005,0.0015,0.0015,1
532,0.014799999999999605,0.5806451612903226,4,9,18,31,26,5,8,15,20,2,0.1,"[0, 20, 40]",0.0005,0.0015,0.0015,3
533,0.023069999999999306,0.5957446808510638,8,12,27,47,42,5,8,15,20,2,0.1,"[0, 20, 40]",0.0005,0.0015,0.0015,5
534,0.005139999999999919,0.6,1,4,5,10,8,2,8,15,20,2,0.1,"[0, 20, 40]",0.0005,0.002,0.001,1
535,0.017849999999999536,0.71875,3,13,16,32,27,5,8,15,20,2,0.1,"[0, 20, 40]",0.0005,0.002,0.001,3
536,0.027979999999999138,0.7083333333333334,6,17,25,48,43,5,8,15,20,2,0.1,"[0, 20, 40]",0.0005,0.002,0.001,5
537,0.0025399999999998727,0.4,1,2,7,10,8,2,8,15,20,2,0.1,"[0, 20, 40]",0.0005,0.002,0.0015,1
538,0.016079999999999556,0.5806451612903226,3,9,19,31,26,5,8,15,20,2,0.1,"[0, 20, 40]",0.0005,0.002,0.0015,3
539,0.02594999999999908,0.5957446808510638,6,12,29,47,42,5,8,15,20,2,0.1,"[0, 20, 40]",0.0005,0.002,0.0015,5
540,0.0071300000000000755,0.7333333333333333,6,5,4,15,14,1,8,15,20,2,0.2,"[0, 20, 40]",0.0003,0.001,0.001,1
541,0.01145000000000011,0.6428571428571429,6,11,11,28,25,3,8,15,20,2,0.2,"[0, 20, 40]",0.0003,0.001,0.001,3
542,0.01619000000000045,0.6944444444444444,9,15,12,36,31,5,8,15,20,2,0.2,"[0, 20, 40]",0.0003,0.001,0.001,5
543,0.007150000000000093,0.6666666666666666,6,4,5,15,14,1,8,15,20,2,0.2,"[0, 20, 40]",0.0003,0.001,0.0015,1
544,0.01024000000000006,0.5357142857142857,6,8,14,28,25,3,8,15,20,2,0.2,"[0, 20, 40]",0.0003,0.001,0.0015,3
545,0.0164800000000004,0.6111111111111112,10,11,15,36,31,5,8,15,20,2,0.2,"[0, 20, 40]",0.0003,0.001,0.0015,5
546,0.007859999999999916,0.7333333333333333,3,6,6,15,14,1,8,15,20,2,0.2,"[0, 20, 40]",0.0003,0.0015,0.001,1
547,0.01167999999999995,0.6428571428571429,2,13,13,28,25,3,8,15,20,2,0.2,"[0, 20, 40]",0.0003,0.0015,0.001,3
548,0.016420000000000236,0.6944444444444444,3,18,15,36,31,5,8,15,20,2,0.2,"[0, 20, 40]",0.0003,0.0015,0.001,5
549,0.008379999999999934,0.6666666666666666,4,4,7,15,14,1,8,15,20,2,0.2,"[0, 20, 40]",0.0003,0.0015,0.0015,1
550,0.0114699999999999,0.5357142857142857,3,9,16,28,25,3,8,15,20,2,0.2,"[0, 20, 40]",0.0003,0.0015,0.0015,3
551,0.016650000000000064,0.5833333333333334,5,12,19,36,31,5,8,15,20,2,0.2,"[0, 20, 40]",0.0003,0.0015,0.0015,5
552,0.008799999999999803,0.7333333333333333,2,6,7,15,14,1,8,15,20,2,0.2,"[0, 20, 40]",0.0003,0.002,0.001,1
553,0.012119999999999836,0.6428571428571429,1,13,14,28,25,3,8,15,20,2,0.2,"[0, 20, 40]",0.0003,0.002,0.001,3
554,0.016310000000000126,0.6944444444444444,1,18,17,36,31,5,8,15,20,2,0.2,"[0, 20, 40]",0.0003,0.002,0.001,5
555,0.009819999999999818,0.6666666666666666,3,4,8,15,14,1,8,15,20,2,0.2,"[0, 20, 40]",0.0003,0.002,0.0015,1
556,0.012409999999999786,0.5357142857142857,2,9,17,28,25,3,8,15,20,2,0.2,"[0, 20, 40]",0.0003,0.002,0.0015,3
557,0.01753999999999996,0.5833333333333334,3,12,21,36,31,5,8,15,20,2,0.2,"[0, 20, 40]",0.0003,0.002,0.0015,5
558,0.0030899999999999235,0.8,1,3,1,5,5,0,8,15,20,2,0.2,"[0, 20, 40]",0.0005,0.001,0.001,1
559,0.007620000000000045,0.6875,3,7,6,16,15,1,8,15,20,2,0.2,"[0, 20, 40]",0.0005,0.001,0.001,3
560,0.013250000000000265,0.7407407407407407,7,11,9,27,26,1,8,15,20,2,0.2,"[0, 20, 40]",0.0005,0.001,0.001,5
561,0.0023099999999999206,0.6,1,2,2,5,5,0,8,15,20,2,0.2,"[0, 20, 40]",0.0005,0.001,0.0015,1
562,0.007329999999999974,0.5625,3,5,8,16,15,1,8,15,20,2,0.2,"[0, 20, 40]",0.0005,0.001,0.0015,3
563,0.012700000000000098,0.6296296296296297,7,8,12,27,26,1,8,15,20,2,0.2,"[0, 20, 40]",0.0005,0.001,0.0015,5
564,0.00291999999999981,0.8,0,3,2,5,5,0,8,15,20,2,0.2,"[0, 20, 40]",0.0005,0.0015,0.001,1
565,0.007829999999999922,0.6875,1,7,8,16,15,1,8,15,20,2,0.2,"[0, 20, 40]",0.0005,0.0015,0.001,3
566,0.014549999999999844,0.7407407407407407,3,11,13,27,26,1,8,15,20,2,0.2,"[0, 20, 40]",0.0005,0.0015,0.001,5
567,0.002139999999999807,0.6,0,2,3,5,5,0,8,15,20,2,0.2,"[0, 20, 40]",0.0005,0.0015,0.0015,1
568,0.0075399999999998515,0.5625,1,5,10,16,15,1,8,15,20,2,0.2,"[0, 20, 40]",0.0005,0.0015,0.0015,3
569,0.013999999999999676,0.6296296296296297,3,8,16,27,26,1,8,15,20,2,0.2,"[0, 20, 40]",0.0005,0.0015,0.0015,5
570,0.00291999999999981,0.8,0,3,2,5,5,0,8,15,20,2,0.2,"[0, 20, 40]",0.0005,0.002,0.001,1
571,0.008329999999999923,0.6875,1,7,8,16,15,1,8,15,20,2,0.2,"[0, 20, 40]",0.0005,0.002,0.001,3
572,0.01564999999999967,0.7407407407407407,2,11,14,27,26,1,8,15,20,2,0.2,"[0, 20, 40]",0.0005,0.002,0.001,5
573,0.002139999999999807,0.6,0,2,3,5,5,0,8,15,20,2,0.2,"[0, 20, 40]",0.0005,0.002,0.0015,1
574,0.008039999999999851,0.5625,1,5,10,16,15,1,8,15,20,2,0.2,"[0, 20, 40]",0.0005,0.002,0.0015,3
575,0.0150999999999995,0.6296296296296297,2,8,17,27,26,1,8,15,20,2,0.2,"[0, 20, 40]",0.0005,0.002,0.0015,5
576,0.005519999999998326,0.3673469387755102,5,10,34,49,31,18,8,16,5,1,0.1,"[0, 20, 40]",0.0003,0.001,0.001,1
577,-0.00497000000000321,0.2727272727272727,6,12,81,99,66,33,8,16,5,1,0.1,"[0, 20, 40]",0.0003,0.001,0.001,3
578,-0.009240000000004286,0.23770491803278687,6,13,103,122,85,37,8,16,5,1,0.1,"[0, 20, 40]",0.0003,0.001,0.001,5
579,-0.0027000000000017934,0.24489795918367346,5,4,40,49,31,18,8,16,5,1,0.1,"[0, 20, 40]",0.0003,0.001,0.0015,1
580,-0.017180000000003495,0.1919191919191919,6,4,89,99,66,33,8,16,5,1,0.1,"[0, 20, 40]",0.0003,0.001,0.0015,3
581,-0.021450000000004542,0.1721311475409836,7,4,111,122,85,37,8,16,5,1,0.1,"[0, 20, 40]",0.0003,0.001,0.0015,5
582,0.004229999999998094,0.3469387755102041,0,11,38,49,31,18,8,16,5,1,0.1,"[0, 20, 40]",0.0003,0.0015,0.001,1
583,-0.006190000000003537,0.26262626262626265,0,13,86,99,66,33,8,16,5,1,0.1,"[0, 20, 40]",0.0003,0.0015,0.001,3
584,-0.010460000000004617,0.22950819672131148,0,14,108,122,85,37,8,16,5,1,0.1,"[0, 20, 40]",0.0003,0.0015,0.001,5
585,-0.005510000000001878,0.20408163265306123,0,4,45,49,31,18,8,16,5,1,0.1,"[0, 20, 40]",0.0003,0.0015,0.0015,1
586,-0.019920000000003667,0.1717171717171717,0,4,95,99,66,33,8,16,5,1,0.1,"[0, 20, 40]",0.0003,0.0015,0.0015,3
587,-0.024090000000004844,0.1557377049180328,0,4,118,122,85,37,8,16,5,1,0.1,"[0, 20, 40]",0.0003,0.0015,0.0015,5
588,0.004229999999998094,0.3469387755102041,0,11,38,49,31,18,8,16,5,1,0.1,"[0, 20, 40]",0.0003,0.002,0.001,1
589,-0.006190000000003537,0.26262626262626265,0,13,86,99,66,33,8,16,5,1,0.1,"[0, 20, 40]",0.0003,0.002,0.001,3
590,-0.010460000000004617,0.22950819672131148,0,14,108,122,85,37,8,16,5,1,0.1,"[0, 20, 40]",0.0003,0.002,0.001,5
591,-0.005510000000001878,0.20408163265306123,0,4,45,49,31,18,8,16,5,1,0.1,"[0, 20, 40]",0.0003,0.002,0.0015,1
592,-0.019920000000003667,0.1717171717171717,0,4,95,99,66,33,8,16,5,1,0.1,"[0, 20, 40]",0.0003,0.002,0.0015,3
593,-0.024090000000004844,0.1557377049180328,0,4,118,122,85,37,8,16,5,1,0.1,"[0, 20, 40]",0.0003,0.002,0.0015,5
594,0.001399999999999468,0.5,1,2,9,12,8,4,8,16,5,1,0.1,"[0, 20, 40]",0.0005,0.001,0.001,1
595,0.004019999999997513,0.4375,5,7,36,48,33,15,8,16,5,1,0.1,"[0, 20, 40]",0.0005,0.001,0.001,3
596,-0.0012200000000037062,0.375,6,7,59,72,56,16,8,16,5,1,0.1,"[0, 20, 40]",0.0005,0.001,0.001,5
597,-0.0031400000000007416,0.3333333333333333,1,0,11,12,8,4,8,16,5,1,0.1,"[0, 20, 40]",0.0005,0.001,0.0015,1
598,-0.010230000000003134,0.2916666666666667,5,0,43,48,33,15,8,16,5,1,0.1,"[0, 20, 40]",0.0005,0.001,0.0015,3
599,-0.015470000000004362,0.2777777777777778,6,0,66,72,56,16,8,16,5,1,0.1,"[0, 20, 40]",0.0005,0.001,0.0015,5
600,0.00042999999999944244,0.4166666666666667,0,2,10,12,8,4,8,16,5,1,0.1,"[0, 20, 40]",0.0005,0.0015,0.001,1
601,0.0024299999999973687,0.3958333333333333,1,7,40,48,33,15,8,16,5,1,0.1,"[0, 20, 40]",0.0005,0.0015,0.001,3
602,-0.002510000000003995,0.3472222222222222,1,7,64,72,56,16,8,16,5,1,0.1,"[0, 20, 40]",0.0005,0.0015,0.001,5
603,-0.004110000000000766,0.25,0,0,12,12,8,4,8,16,5,1,0.1,"[0, 20, 40]",0.0005,0.0015,0.0015,1
604,-0.011820000000003283,0.25,1,0,47,48,33,15,8,16,5,1,0.1,"[0, 20, 40]",0.0005,0.0015,0.0015,3
605,-0.016760000000004646,0.25,1,0,71,72,56,16,8,16,5,1,0.1,"[0, 20, 40]",0.0005,0.0015,0.0015,5
606,0.00042999999999944244,0.4166666666666667,0,2,10,12,8,4,8,16,5,1,0.1,"[0, 20, 40]",0.0005,0.002,0.001,1
607,0.002689999999997352,0.3958333333333333,0,7,41,48,33,15,8,16,5,1,0.1,"[0, 20, 40]",0.0005,0.002,0.001,3
608,-0.0022500000000040114,0.3472222222222222,0,7,65,72,56,16,8,16,5,1,0.1,"[0, 20, 40]",0.0005,0.002,0.001,5
609,-0.004110000000000766,0.25,0,0,12,12,8,4,8,16,5,1,0.1,"[0, 20, 40]",0.0005,0.002,0.0015,1
610,-0.011560000000003299,0.25,0,0,48,48,33,15,8,16,5,1,0.1,"[0, 20, 40]",0.0005,0.002,0.0015,3
611,-0.016500000000004664,0.25,0,0,72,72,56,16,8,16,5,1,0.1,"[0, 20, 40]",0.0005,0.002,0.0015,5
612,0.004079999999999416,0.4,3,4,18,25,20,5,8,16,5,1,0.2,"[0, 20, 40]",0.0003,0.001,0.001,1
613,-0.0031300000000011427,0.3125,3,5,40,48,39,9,8,16,5,1,0.2,"[0, 20, 40]",0.0003,0.001,0.001,3
614,-0.007120000000001139,0.2459016393442623,3,5,53,61,50,11,8,16,5,1,0.2,"[0, 20, 40]",0.0003,0.001,0.001,5
615,0.0014799999999993685,0.32,3,2,20,25,20,5,8,16,5,1,0.2,"[0, 20, 40]",0.0003,0.001,0.0015,1
616,-0.007510000000001191,0.25,3,2,43,48,39,9,8,16,5,1,0.2,"[0, 20, 40]",0.0003,0.001,0.0015,3
617,-0.011500000000001198,0.19672131147540983,3,2,56,61,50,11,8,16,5,1,0.2,"[0, 20, 40]",0.0003,0.001,0.0015,5
618,0.002729999999999345,0.36,0,4,21,25,20,5,8,16,5,1,0.2,"[0, 20, 40]",0.0003,0.0015,0.001,1
619,-0.004480000000001213,0.2916666666666667,0,5,43,48,39,9,8,16,5,1,0.2,"[0, 20, 40]",0.0003,0.0015,0.001,3
620,-0.00847000000000121,0.22950819672131148,0,5,56,61,50,11,8,16,5,1,0.2,"[0, 20, 40]",0.0003,0.0015,0.001,5
621,0.00012999999999929745,0.28,0,2,23,25,20,5,8,16,5,1,0.2,"[0, 20, 40]",0.0003,0.0015,0.0015,1
622,-0.008860000000001263,0.22916666666666666,0,2,46,48,39,9,8,16,5,1,0.2,"[0, 20, 40]",0.0003,0.0015,0.0015,3
623,-0.01285000000000127,0.18032786885245902,0,2,59,61,50,11,8,16,5,1,0.2,"[0, 20, 40]",0.0003,0.0015,0.0015,5
624,0.002729999999999345,0.36,0,4,21,25,20,5,8,16,5,1,0.2,"[0, 20, 40]",0.0003,0.002,0.001,1
625,-0.004480000000001213,0.2916666666666667,0,5,43,48,39,9,8,16,5,1,0.2,"[0, 20, 40]",0.0003,0.002,0.001,3
626,-0.00847000000000121,0.22950819672131148,0,5,56,61,50,11,8,16,5,1,0.2,"[0, 20, 40]",0.0003,0.002,0.001,5
627,0.00012999999999929745,0.28,0,2,23,25,20,5,8,16,5,1,0.2,"[0, 20, 40]",0.0003,0.002,0.0015,1
628,-0.008860000000001263,0.22916666666666666,0,2,46,48,39,9,8,16,5,1,0.2,"[0, 20, 40]",0.0003,0.002,0.0015,3
629,-0.01285000000000127,0.18032786885245902,0,2,59,61,50,11,8,16,5,1,0.2,"[0, 20, 40]",0.0003,0.002,0.0015,5
630,0.0016399999999996196,0.6666666666666666,0,1,5,6,5,1,8,16,5,1,0.2,"[0, 20, 40]",0.0005,0.001,0.001,1
631,0.0001299999999985874,0.4074074074074074,2,3,22,27,22,5,8,16,5,1,0.2,"[0, 20, 40]",0.0005,0.001,0.001,3
632,-0.0042100000000019535,0.3170731707317073,2,3,36,41,36,5,8,16,5,1,0.2,"[0, 20, 40]",0.0005,0.001,0.001,5
633,-0.0006400000000005502,0.5,0,0,6,6,5,1,8,16,5,1,0.2,"[0, 20, 40]",0.0005,0.001,0.0015,1
634,-0.006210000000001751,0.2962962962962963,2,0,25,27,22,5,8,16,5,1,0.2,"[0, 20, 40]",0.0005,0.001,0.0015,3
635,-0.010550000000002295,0.24390243902439024,2,0,39,41,36,5,8,16,5,1,0.2,"[0, 20, 40]",0.0005,0.001,0.0015,5
636,0.0016399999999996196,0.6666666666666666,0,1,5,6,5,1,8,16,5,1,0.2,"[0, 20, 40]",0.0005,0.0015,0.001,1
637,-0.0001500000000015259,0.37037037037037035,1,3,23,27,22,5,8,16,5,1,0.2,"[0, 20, 40]",0.0005,0.0015,0.001,3
638,-0.004490000000002067,0.2926829268292683,1,3,37,41,36,5,8,16,5,1,0.2,"[0, 20, 40]",0.0005,0.0015,0.001,5
639,-0.0006400000000005502,0.5,0,0,6,6,5,1,8,16,5,1,0.2,"[0, 20, 40]",0.0005,0.0015,0.0015,1
640,-0.006490000000001864,0.25925925925925924,1,0,26,27,22,5,8,16,5,1,0.2,"[0, 20, 40]",0.0005,0.0015,0.0015,3
641,-0.01083000000000241,0.21951219512195122,1,0,40,41,36,5,8,16,5,1,0.2,"[0, 20, 40]",0.0005,0.0015,0.0015,5
642,0.0016399999999996196,0.6666666666666666,0,1,5,6,5,1,8,16,5,1,0.2,"[0, 20, 40]",0.0005,0.002,0.001,1
643,0.00010999999999845788,0.37037037037037035,0,3,24,27,22,5,8,16,5,1,0.2,"[0, 20, 40]",0.0005,0.002,0.001,3
644,-0.004230000000002084,0.2926829268292683,0,3,38,41,36,5,8,16,5,1,0.2,"[0, 20, 40]",0.0005,0.002,0.001,5
645,-0.0006400000000005502,0.5,0,0,6,6,5,1,8,16,5,1,0.2,"[0, 20, 40]",0.0005,0.002,0.0015,1
646,-0.006230000000001881,0.25925925925925924,0,0,27,27,22,5,8,16,5,1,0.2,"[0, 20, 40]",0.0005,0.002,0.0015,3
647,-0.010570000000002426,0.21951219512195122,0,0,41,41,36,5,8,16,5,1,0.2,"[0, 20, 40]",0.0005,0.002,0.0015,5
648,0.0005899999999988468,0.3055555555555556,3,5,28,36,26,10,8,16,5,2,0.1,"[0, 20, 40]",0.0003,0.001,0.001,1
649,-0.010440000000003249,0.2222222222222222,4,7,70,81,62,19,8,16,5,2,0.1,"[0, 20, 40]",0.0003,0.001,0.001,3
650,-0.013680000000004145,0.2,4,8,88,100,79,21,8,16,5,2,0.1,"[0, 20, 40]",0.0003,0.001,0.001,5
651,-0.001170000000001194,0.25,3,3,30,36,26,10,8,16,5,2,0.1,"[0, 20, 40]",0.0003,0.001,0.0015,1
652,-0.016190000000003434,0.1728395061728395,4,3,74,81,62,19,8,16,5,2,0.1,"[0, 20, 40]",0.0003,0.001,0.0015,3
653,-0.01943000000000432,0.16,5,3,92,100,79,21,8,16,5,2,0.1,"[0, 20, 40]",0.0003,0.001,0.0015,5
654,-0.0012000000000012205,0.2777777777777778,0,5,31,36,26,10,8,16,5,2,0.1,"[0, 20, 40]",0.0003,0.0015,0.001,1
655,-0.012160000000003413,0.20987654320987653,0,7,74,81,62,19,8,16,5,2,0.1,"[0, 20, 40]",0.0003,0.0015,0.001,3
656,-0.015400000000004308,0.19,0,8,92,100,79,21,8,16,5,2,0.1,"[0, 20, 40]",0.0003,0.0015,0.001,5
657,-0.0029600000000012602,0.2222222222222222,0,3,33,36,26,10,8,16,5,2,0.1,"[0, 20, 40]",0.0003,0.0015,0.0015,1
658,-0.017910000000003593,0.16049382716049382,0,3,78,81,62,19,8,16,5,2,0.1,"[0, 20, 40]",0.0003,0.0015,0.0015,3
659,-0.0210500000000046,0.15,0,3,97,100,79,21,8,16,5,2,0.1,"[0, 20, 40]",0.0003,0.0015,0.0015,5
660,-0.0012000000000012205,0.2777777777777778,0,5,31,36,26,10,8,16,5,2,0.1,"[0, 20, 40]",0.0003,0.002,0.001,1
661,-0.012160000000003413,0.20987654320987653,0,7,74,81,62,19,8,16,5,2,0.1,"[0, 20, 40]",0.0003,0.002,0.001,3
662,-0.015400000000004308,0.19,0,8,92,100,79,21,8,16,5,2,0.1,"[0, 20, 40]",0.0003,0.002,0.001,5
663,-0.0029600000000012602,0.2222222222222222,0,3,33,36,26,10,8,16,5,2,0.1,"[0, 20, 40]",0.0003,0.002,0.0015,1
664,-0.017910000000003593,0.16049382716049382,0,3,78,81,62,19,8,16,5,2,0.1,"[0, 20, 40]",0.0003,0.002,0.0015,3
665,-0.0210500000000046,0.15,0,3,97,100,79,21,8,16,5,2,0.1,"[0, 20, 40]",0.0003,0.002,0.0015,5
666,0.0014699999999996823,0.46153846153846156,1,2,10,13,10,3,8,16,5,2,0.1,"[0, 20, 40]",0.0005,0.001,0.001,1
667,0.0021299999999983194,0.41025641025641024,3,6,30,39,33,6,8,16,5,2,0.1,"[0, 20, 40]",0.0005,0.001,0.001,3
668,-0.0013500000000024035,0.36666666666666664,4,6,50,60,54,6,8,16,5,2,0.1,"[0, 20, 40]",0.0005,0.001,0.001,5
669,-0.003070000000000527,0.3076923076923077,1,0,12,13,10,3,8,16,5,2,0.1,"[0, 20, 40]",0.0005,0.001,0.0015,1
670,-0.010320000000002412,0.2564102564102564,3,0,36,39,33,6,8,16,5,2,0.1,"[0, 20, 40]",0.0005,0.001,0.0015,3
671,-0.013800000000003141,0.26666666666666666,4,0,56,60,54,6,8,16,5,2,0.1,"[0, 20, 40]",0.0005,0.001,0.0015,5
672,0.000499999999999657,0.38461538461538464,0,2,11,13,10,3,8,16,5,2,0.1,"[0, 20, 40]",0.0005,0.0015,0.001,1
673,0.0005199999999981004,0.358974358974359,0,6,33,39,33,6,8,16,5,2,0.1,"[0, 20, 40]",0.0005,0.0015,0.001,3
674,-0.0026600000000027674,0.3333333333333333,0,6,54,60,54,6,8,16,5,2,0.1,"[0, 20, 40]",0.0005,0.0015,0.001,5
675,-0.004040000000000551,0.23076923076923078,0,0,13,13,10,3,8,16,5,2,0.1,"[0, 20, 40]",0.0005,0.0015,0.0015,1
676,-0.011930000000002638,0.20512820512820512,0,0,39,39,33,6,8,16,5,2,0.1,"[0, 20, 40]",0.0005,0.0015,0.0015,3
677,-0.015110000000003506,0.23333333333333334,0,0,60,60,54,6,8,16,5,2,0.1,"[0, 20, 40]",0.0005,0.0015,0.0015,5
678,0.000499999999999657,0.38461538461538464,0,2,11,13,10,3,8,16,5,2,0.1,"[0, 20, 40]",0.0005,0.002,0.001,1
679,0.0005199999999981004,0.358974358974359,0,6,33,39,33,6,8,16,5,2,0.1,"[0, 20, 40]",0.0005,0.002,0.001,3
680,-0.0026600000000027674,0.3333333333333333,0,6,54,60,54,6,8,16,5,2,0.1,"[0, 20, 40]",0.0005,0.002,0.001,5
681,-0.004040000000000551,0.23076923076923078,0,0,13,13,10,3,8,16,5,2,0.1,"[0, 20, 40]",0.0005,0.002,0.0015,1
682,-0.011930000000002638,0.20512820512820512,0,0,39,39,33,6,8,16,5,2,0.1,"[0, 20, 40]",0.0005,0.002,0.0015,3
683,-0.015110000000003506,0.23333333333333334,0,0,60,60,54,6,8,16,5,2,0.1,"[0, 20, 40]",0.0005,0.002,0.0015,5
684,0.0011599999999995384,0.3888888888888889,3,2,13,18,17,1,8,16,5,2,0.2,"[0, 20, 40]",0.0003,0.001,0.001,1
685,-0.00555000000000151,0.2682926829268293,3,3,35,41,37,4,8,16,5,2,0.2,"[0, 20, 40]",0.0003,0.001,0.001,3
686,-0.007990000000001685,0.2222222222222222,3,4,47,54,48,6,8,16,5,2,0.2,"[0, 20, 40]",0.0003,0.001,0.001,5
687,0.002159999999999537,0.3888888888888889,3,2,13,18,17,1,8,16,5,2,0.2,"[0, 20, 40]",0.0003,0.001,0.0015,1
688,-0.006330000000001517,0.24390243902439024,3,2,36,41,37,4,8,16,5,2,0.2,"[0, 20, 40]",0.0003,0.001,0.0015,3
689,-0.008770000000001691,0.2037037037037037,4,2,48,54,48,6,8,16,5,2,0.2,"[0, 20, 40]",0.0003,0.001,0.0015,5
690,-0.0006300000000005284,0.3333333333333333,0,2,16,18,17,1,8,16,5,2,0.2,"[0, 20, 40]",0.0003,0.0015,0.001,1
691,-0.007340000000001577,0.24390243902439024,0,3,38,41,37,4,8,16,5,2,0.2,"[0, 20, 40]",0.0003,0.0015,0.001,3
692,-0.009780000000001753,0.2037037037037037,0,4,50,54,48,6,8,16,5,2,0.2,"[0, 20, 40]",0.0003,0.0015,0.001,5
693,0.0003699999999994706,0.3333333333333333,0,2,16,18,17,1,8,16,5,2,0.2,"[0, 20, 40]",0.0003,0.0015,0.0015,1
694,-0.008120000000001583,0.21951219512195122,0,2,39,41,37,4,8,16,5,2,0.2,"[0, 20, 40]",0.0003,0.0015,0.0015,3
695,-0.010460000000001881,0.18518518518518517,0,2,52,54,48,6,8,16,5,2,0.2,"[0, 20, 40]",0.0003,0.0015,0.0015,5
696,-0.0006300000000005284,0.3333333333333333,0,2,16,18,17,1,8,16,5,2,0.2,"[0, 20, 40]",0.0003,0.002,0.001,1
697,-0.007340000000001577,0.24390243902439024,0,3,38,41,37,4,8,16,5,2,0.2,"[0, 20, 40]",0.0003,0.002,0.001,3
698,-0.009780000000001753,0.2037037037037037,0,4,50,54,48,6,8,16,5,2,0.2,"[0, 20, 40]",0.0003,0.002,0.001,5
699,0.0003699999999994706,0.3333333333333333,0,2,16,18,17,1,8,16,5,2,0.2,"[0, 20, 40]",0.0003,0.002,0.0015,1
700,-0.008120000000001583,0.21951219512195122,0,2,39,41,37,4,8,16,5,2,0.2,"[0, 20, 40]",0.0003,0.002,0.0015,3
701,-0.010460000000001881,0.18518518518518517,0,2,52,54,48,6,8,16,5,2,0.2,"[0, 20, 40]",0.0003,0.002,0.0015,5
702,-0.0002700000000002365,0.3333333333333333,0,1,5,6,6,0,8,16,5,2,0.2,"[0, 20, 40]",0.0005,0.001,0.001,1
703,0.00016999999999922557,0.4,2,3,15,20,19,1,8,16,5,2,0.2,"[0, 20, 40]",0.0005,0.001,0.001,3
704,-0.002040000000001263,0.34285714285714286,3,3,29,35,34,1,8,16,5,2,0.2,"[0, 20, 40]",0.0005,0.001,0.001,5
705,-0.002550000000000407,0.16666666666666666,0,0,6,6,6,0,8,16,5,2,0.2,"[0, 20, 40]",0.0005,0.001,0.0015,1
706,-0.006170000000001115,0.25,2,0,18,20,19,1,8,16,5,2,0.2,"[0, 20, 40]",0.0005,0.001,0.0015,3
707,-0.008380000000001603,0.2571428571428571,3,0,32,35,34,1,8,16,5,2,0.2,"[0, 20, 40]",0.0005,0.001,0.0015,5
708,-0.0002700000000002365,0.3333333333333333,0,1,5,6,6,0,8,16,5,2,0.2,"[0, 20, 40]",0.0005,0.0015,0.001,1
709,-0.00047000000000096867,0.35,0,3,17,20,19,1,8,16,5,2,0.2,"[0, 20, 40]",0.0005,0.0015,0.001,3
710,-0.0023800000000016,0.3142857142857143,0,3,32,35,34,1,8,16,5,2,0.2,"[0, 20, 40]",0.0005,0.0015,0.001,5
711,-0.002550000000000407,0.16666666666666666,0,0,6,6,6,0,8,16,5,2,0.2,"[0, 20, 40]",0.0005,0.0015,0.0015,1
712,-0.006810000000001309,0.2,0,0,20,20,19,1,8,16,5,2,0.2,"[0, 20, 40]",0.0005,0.0015,0.0015,3
713,-0.00872000000000194,0.22857142857142856,0,0,35,35,34,1,8,16,5,2,0.2,"[0, 20, 40]",0.0005,0.0015,0.0015,5
714,-0.0002700000000002365,0.3333333333333333,0,1,5,6,6,0,8,16,5,2,0.2,"[0, 20, 40]",0.0005,0.002,0.001,1
715,-0.00047000000000096867,0.35,0,3,17,20,19,1,8,16,5,2,0.2,"[0, 20, 40]",0.0005,0.002,0.001,3
716,-0.0023800000000016,0.3142857142857143,0,3,32,35,34,1,8,16,5,2,0.2,"[0, 20, 40]",0.0005,0.002,0.001,5
717,-0.002550000000000407,0.16666666666666666,0,0,6,6,6,0,8,16,5,2,0.2,"[0, 20, 40]",0.0005,0.002,0.0015,1
718,-0.006810000000001309,0.2,0,0,20,20,19,1,8,16,5,2,0.2,"[0, 20, 40]",0.0005,0.002,0.0015,3
719,-0.00872000000000194,0.22857142857142856,0,0,35,35,34,1,8,16,5,2,0.2,"[0, 20, 40]",0.0005,0.002,0.0015,5
720,0.01264999999999851,0.5714285714285714,10,12,27,49,31,18,8,16,10,1,0.1,"[0, 20, 40]",0.0003,0.001,0.001,1
721,0.010489999999998207,0.45,18,19,63,100,67,33,8,16,10,1,0.1,"[0, 20, 40]",0.0003,0.001,0.001,3
722,0.015109999999997627,0.4596774193548387,21,23,80,124,87,37,8,16,10,1,0.1,"[0, 20, 40]",0.0003,0.001,0.001,5
723,0.005659999999998628,0.42857142857142855,10,5,34,49,31,18,8,16,10,1,0.1,"[0, 20, 40]",0.0003,0.001,0.0015,1
724,6.999999999817775e-05,0.35,18,9,73,100,67,33,8,16,10,1,0.1,"[0, 20, 40]",0.0003,0.001,0.0015,3
725,0.0017899999999975349,0.3629032258064516,22,10,92,124,87,37,8,16,10,1,0.1,"[0, 20, 40]",0.0003,0.001,0.0015,5
726,0.014099999999998235,0.5714285714285714,4,14,31,49,31,18,8,16,10,1,0.1,"[0, 20, 40]",0.0003,0.0015,0.001,1
727,0.011079999999997639,0.45,4,21,75,100,67,33,8,16,10,1,0.1,"[0, 20, 40]",0.0003,0.0015,0.001,3
728,0.01425999999999662,0.45161290322580644,4,25,95,124,87,37,8,16,10,1,0.1,"[0, 20, 40]",0.0003,0.0015,0.001,5
729,0.006929999999998232,0.40816326530612246,5,5,39,49,31,18,8,16,10,1,0.1,"[0, 20, 40]",0.0003,0.0015,0.0015,1
730,0.00047999999999748515,0.34,5,9,86,100,67,33,8,16,10,1,0.1,"[0, 20, 40]",0.0003,0.0015,0.0015,3
731,0.0010199999999962127,0.3467741935483871,5,10,109,124,87,37,8,16,10,1,0.1,"[0, 20, 40]",0.0003,0.0015,0.0015,5
732,0.013769999999998075,0.5714285714285714,2,14,33,49,31,18,8,16,10,1,0.1,"[0, 20, 40]",0.0003,0.002,0.001,1
733,0.010749999999997477,0.45,2,21,77,100,67,33,8,16,10,1,0.1,"[0, 20, 40]",0.0003,0.002,0.001,3
734,0.01392999999999646,0.45161290322580644,2,25,97,124,87,37,8,16,10,1,0.1,"[0, 20, 40]",0.0003,0.002,0.001,5
735,0.006929999999998072,0.40816326530612246,2,5,42,49,31,18,8,16,10,1,0.1,"[0, 20, 40]",0.0003,0.002,0.0015,1
736,0.0004799999999973234,0.34,2,9,89,100,67,33,8,16,10,1,0.1,"[0, 20, 40]",0.0003,0.002,0.0015,3
737,0.0010199999999960527,0.3467741935483871,2,10,112,124,87,37,8,16,10,1,0.1,"[0, 20, 40]",0.0003,0.002,0.0015,5
738,0.004539999999999829,0.6666666666666666,3,4,5,12,8,4,8,16,10,1,0.1,"[0, 20, 40]",0.0005,0.001,0.001,1
739,0.013529999999999166,0.5714285714285714,13,11,25,49,34,15,8,16,10,1,0.1,"[0, 20, 40]",0.0005,0.001,0.001,3
740,0.017859999999998013,0.5540540540540541,19,14,41,74,58,16,8,16,10,1,0.1,"[0, 20, 40]",0.0005,0.001,0.001,5
741,0.00027999999999984504,0.4166666666666667,3,1,8,12,8,4,8,16,10,1,0.1,"[0, 20, 40]",0.0005,0.001,0.0015,1
742,0.006759999999999062,0.4489795918367347,13,5,31,49,34,15,8,16,10,1,0.1,"[0, 20, 40]",0.0005,0.001,0.0015,3
743,0.010649999999997667,0.4594594594594595,19,7,48,74,58,16,8,16,10,1,0.1,"[0, 20, 40]",0.0005,0.001,0.0015,5
744,0.0033099999999995993,0.5,1,4,7,12,8,4,8,16,10,1,0.1,"[0, 20, 40]",0.0005,0.0015,0.001,1
745,0.015479999999998785,0.5306122448979592,7,11,31,49,34,15,8,16,10,1,0.1,"[0, 20, 40]",0.0005,0.0015,0.001,3
746,0.020959999999997054,0.527027027027027,9,14,51,74,58,16,8,16,10,1,0.1,"[0, 20, 40]",0.0005,0.0015,0.001,5
747,-0.000950000000000385,0.25,1,1,10,12,8,4,8,16,10,1,0.1,"[0, 20, 40]",0.0005,0.0015,0.0015,1
748,0.008709999999998675,0.40816326530612246,7,5,37,49,34,15,8,16,10,1,0.1,"[0, 20, 40]",0.0005,0.0015,0.0015,3
749,0.013749999999996713,0.43243243243243246,9,7,58,74,58,16,8,16,10,1,0.1,"[0, 20, 40]",0.0005,0.0015,0.0015,5
750,0.0038099999999995993,0.5,1,4,7,12,8,4,8,16,10,1,0.1,"[0, 20, 40]",0.0005,0.002,0.001,1
751,0.013949999999998257,0.5102040816326531,3,11,35,49,34,15,8,16,10,1,0.1,"[0, 20, 40]",0.0005,0.002,0.001,3
752,0.019469999999996466,0.5135135135135135,4,14,56,74,58,16,8,16,10,1,0.1,"[0, 20, 40]",0.0005,0.002,0.001,5
753,-0.000450000000000385,0.25,1,1,10,12,8,4,8,16,10,1,0.1,"[0, 20, 40]",0.0005,0.002,0.0015,1
754,0.007179999999998154,0.3877551020408163,3,5,41,49,34,15,8,16,10,1,0.1,"[0, 20, 40]",0.0005,0.002,0.0015,3
755,0.012259999999996118,0.4189189189189189,4,7,63,74,58,16,8,16,10,1,0.1,"[0, 20, 40]",0.0005,0.002,0.0015,5
756,0.00774999999999992,0.64,8,5,12,25,20,5,8,16,10,1,0.2,"[0, 20, 40]",0.0003,0.001,0.001,1
757,0.005129999999999895,0.4583333333333333,10,8,30,48,39,9,8,16,10,1,0.2,"[0, 20, 40]",0.0003,0.001,0.001,3
758,0.009329999999999674,0.4838709677419355,12,11,39,62,51,11,8,16,10,1,0.2,"[0, 20, 40]",0.0003,0.001,0.001,5
759,0.004979999999999981,0.52,8,2,15,25,20,5,8,16,10,1,0.2,"[0, 20, 40]",0.0003,0.001,0.0015,1
760,0.001199999999999906,0.375,10,4,34,48,39,9,8,16,10,1,0.2,"[0, 20, 40]",0.0003,0.001,0.0015,3
761,0.002499999999999616,0.3870967741935484,12,5,45,62,51,11,8,16,10,1,0.2,"[0, 20, 40]",0.0003,0.001,0.0015,5
762,0.00869999999999965,0.64,3,6,16,25,20,5,8,16,10,1,0.2,"[0, 20, 40]",0.0003,0.0015,0.001,1
763,0.005559999999999551,0.4583333333333333,3,9,36,48,39,9,8,16,10,1,0.2,"[0, 20, 40]",0.0003,0.0015,0.001,3
764,0.008279999999998965,0.46774193548387094,3,12,47,62,51,11,8,16,10,1,0.2,"[0, 20, 40]",0.0003,0.0015,0.001,5
765,0.005249999999999589,0.48,3,2,20,25,20,5,8,16,10,1,0.2,"[0, 20, 40]",0.0003,0.0015,0.0015,1
766,0.0009499999999994387,0.3541666666666667,3,4,41,48,39,9,8,16,10,1,0.2,"[0, 20, 40]",0.0003,0.0015,0.0015,3
767,0.000769999999998781,0.3548387096774194,3,5,54,62,51,11,8,16,10,1,0.2,"[0, 20, 40]",0.0003,0.0015,0.0015,5
768,0.007869999999999489,0.64,1,6,18,25,20,5,8,16,10,1,0.2,"[0, 20, 40]",0.0003,0.002,0.001,1
769,0.004729999999999388,0.4583333333333333,1,9,38,48,39,9,8,16,10,1,0.2,"[0, 20, 40]",0.0003,0.002,0.001,3
770,0.007449999999998805,0.46774193548387094,1,12,49,62,51,11,8,16,10,1,0.2,"[0, 20, 40]",0.0003,0.002,0.001,5
771,0.004419999999999425,0.48,1,2,22,25,20,5,8,16,10,1,0.2,"[0, 20, 40]",0.0003,0.002,0.0015,1
772,0.00011999999999927615,0.3541666666666667,1,4,43,48,39,9,8,16,10,1,0.2,"[0, 20, 40]",0.0003,0.002,0.0015,3
773,-6.000000000138048e-05,0.3548387096774194,1,5,56,62,51,11,8,16,10,1,0.2,"[0, 20, 40]",0.0003,0.002,0.0015,5
774,0.0018,0.6666666666666666,2,1,3,6,5,1,8,16,10,1,0.2,"[0, 20, 40]",0.0005,0.001,0.001,1
775,0.0057399999999998095,0.5555555555555556,7,4,16,27,22,5,8,16,10,1,0.2,"[0, 20, 40]",0.0005,0.001,0.001,3
776,0.008269999999999063,0.5476190476190477,9,7,26,42,37,5,8,16,10,1,0.2,"[0, 20, 40]",0.0005,0.001,0.001,5
777,0.0023,0.6666666666666666,2,1,3,6,5,1,8,16,10,1,0.2,"[0, 20, 40]",0.0005,0.001,0.0015,1
778,0.005239999999999695,0.5185185185185185,7,3,17,27,22,5,8,16,10,1,0.2,"[0, 20, 40]",0.0005,0.001,0.0015,3
779,0.007329999999998728,0.5,9,5,28,42,37,5,8,16,10,1,0.2,"[0, 20, 40]",0.0005,0.001,0.0015,5
780,0.0016799999999998249,0.5,1,1,4,6,5,1,8,16,10,1,0.2,"[0, 20, 40]",0.0005,0.0015,0.001,1
781,0.006559999999999577,0.5185185185185185,3,4,20,27,22,5,8,16,10,1,0.2,"[0, 20, 40]",0.0005,0.0015,0.001,3
782,0.008529999999998717,0.5238095238095238,3,7,32,42,37,5,8,16,10,1,0.2,"[0, 20, 40]",0.0005,0.0015,0.001,5
783,0.002179999999999825,0.5,1,1,4,6,5,1,8,16,10,1,0.2,"[0, 20, 40]",0.0005,0.0015,0.0015,1
784,0.006059999999999463,0.48148148148148145,3,3,21,27,22,5,8,16,10,1,0.2,"[0, 20, 40]",0.0005,0.0015,0.0015,3
785,0.007589999999998383,0.47619047619047616,3,5,34,42,37,5,8,16,10,1,0.2,"[0, 20, 40]",0.0005,0.0015,0.0015,5
786,0.002179999999999825,0.5,1,1,4,6,5,1,8,16,10,1,0.2,"[0, 20, 40]",0.0005,0.002,0.001,1
787,0.005409999999999315,0.48148148148148145,1,4,22,27,22,5,8,16,10,1,0.2,"[0, 20, 40]",0.0005,0.002,0.001,3
788,0.007379999999998456,0.5,1,7,34,42,37,5,8,16,10,1,0.2,"[0, 20, 40]",0.0005,0.002,0.001,5
789,0.002679999999999825,0.5,1,1,4,6,5,1,8,16,10,1,0.2,"[0, 20, 40]",0.0005,0.002,0.0015,1
790,0.004909999999999202,0.4444444444444444,1,3,23,27,22,5,8,16,10,1,0.2,"[0, 20, 40]",0.0005,0.002,0.0015,3
791,0.0064399999999981234,0.4523809523809524,1,5,36,42,37,5,8,16,10,1,0.2,"[0, 20, 40]",0.0005,0.002,0.0015,5
792,0.004979999999998736,0.4722222222222222,5,7,24,36,26,10,8,16,10,2,0.1,"[0, 20, 40]",0.0003,0.001,0.001,1
793,0.004809999999997708,0.4024390243902439,12,14,56,82,63,19,8,16,10,2,0.1,"[0, 20, 40]",0.0003,0.001,0.001,3
794,0.009539999999997273,0.43137254901960786,15,18,69,102,81,21,8,16,10,2,0.1,"[0, 20, 40]",0.0003,0.001,0.001,5
795,0.002379999999998912,0.3888888888888889,5,4,27,36,26,10,8,16,10,2,0.1,"[0, 20, 40]",0.0003,0.001,0.0015,1
796,0.0005299999999978199,0.34146341463414637,12,9,61,82,63,19,8,16,10,2,0.1,"[0, 20, 40]",0.0003,0.001,0.0015,3
797,0.002359999999997315,0.3627450980392157,16,10,76,102,81,21,8,16,10,2,0.1,"[0, 20, 40]",0.0003,0.001,0.0015,5
798,0.004989999999998692,0.4722222222222222,2,8,26,36,26,10,8,16,10,2,0.1,"[0, 20, 40]",0.0003,0.0015,0.001,1
799,0.004329999999997453,0.4024390243902439,2,15,65,82,63,19,8,16,10,2,0.1,"[0, 20, 40]",0.0003,0.0015,0.001,3
800,0.00761999999999659,0.4215686274509804,2,19,81,102,81,21,8,16,10,2,0.1,"[0, 20, 40]",0.0003,0.0015,0.001,5
801,0.0017099999999987433,0.3611111111111111,2,4,30,36,26,10,8,16,10,2,0.1,"[0, 20, 40]",0.0003,0.0015,0.0015,1
802,-0.0006300000000025571,0.32926829268292684,2,9,71,82,63,19,8,16,10,2,0.1,"[0, 20, 40]",0.0003,0.0015,0.0015,3
803,1.9999999996312003e-05,0.3431372549019608,2,10,90,102,81,21,8,16,10,2,0.1,"[0, 20, 40]",0.0003,0.0015,0.0015,5
804,0.005429999999998799,0.4722222222222222,1,8,27,36,26,10,8,16,10,2,0.1,"[0, 20, 40]",0.0003,0.002,0.001,1
805,0.004769999999997562,0.4024390243902439,1,15,66,82,63,19,8,16,10,2,0.1,"[0, 20, 40]",0.0003,0.002,0.001,3
806,0.008059999999996697,0.4215686274509804,1,19,82,102,81,21,8,16,10,2,0.1,"[0, 20, 40]",0.0003,0.002,0.001,5
807,0.002149999999998851,0.3611111111111111,1,4,31,36,26,10,8,16,10,2,0.1,"[0, 20, 40]",0.0003,0.002,0.0015,1
808,-0.0001900000000024493,0.32926829268292684,1,9,72,82,63,19,8,16,10,2,0.1,"[0, 20, 40]",0.0003,0.002,0.0015,3
809,0.00045999999999641987,0.3431372549019608,1,10,91,102,81,21,8,16,10,2,0.1,"[0, 20, 40]",0.0003,0.002,0.0015,5
810,0.0029099999999998983,0.5384615384615384,3,3,7,13,10,3,8,16,10,2,0.1,"[0, 20, 40]",0.0005,0.001,0.001,1
811,0.01127999999999928,0.575,10,10,20,40,34,6,8,16,10,2,0.1,"[0, 20, 40]",0.0005,0.001,0.001,3
812,0.016619999999998362,0.5645161290322581,16,13,33,62,56,6,8,16,10,2,0.1,"[0, 20, 40]",0.0005,0.001,0.001,5
813,-0.0004700000000002054,0.38461538461538464,3,1,9,13,10,3,8,16,10,2,0.1,"[0, 20, 40]",0.0005,0.001,0.0015,1
814,0.007099999999999098,0.475,10,6,24,40,34,6,8,16,10,2,0.1,"[0, 20, 40]",0.0005,0.001,0.0015,3
815,0.011999999999997948,0.4838709677419355,16,8,38,62,56,6,8,16,10,2,0.1,"[0, 20, 40]",0.0005,0.001,0.0015,5
816,0.0016799999999996692,0.38461538461538464,1,3,9,13,10,3,8,16,10,2,0.1,"[0, 20, 40]",0.0005,0.0015,0.001,1
817,0.0117299999999989,0.525,4,10,26,40,34,6,8,16,10,2,0.1,"[0, 20, 40]",0.0005,0.0015,0.001,3
818,0.01821999999999742,0.532258064516129,6,13,43,62,56,6,8,16,10,2,0.1,"[0, 20, 40]",0.0005,0.0015,0.001,5
819,-0.0017000000000004355,0.23076923076923078,1,1,11,13,10,3,8,16,10,2,0.1,"[0, 20, 40]",0.0005,0.0015,0.0015,1
820,0.007549999999998719,0.425,4,6,30,40,34,6,8,16,10,2,0.1,"[0, 20, 40]",0.0005,0.0015,0.0015,3
821,0.013599999999996998,0.45161290322580644,6,8,48,62,56,6,8,16,10,2,0.1,"[0, 20, 40]",0.0005,0.0015,0.0015,5
822,0.002179999999999669,0.38461538461538464,1,3,9,13,10,3,8,16,10,2,0.1,"[0, 20, 40]",0.0005,0.002,0.001,1
823,0.01134999999999863,0.525,2,10,28,40,34,6,8,16,10,2,0.1,"[0, 20, 40]",0.0005,0.002,0.001,3
824,0.017879999999997082,0.532258064516129,3,13,46,62,56,6,8,16,10,2,0.1,"[0, 20, 40]",0.0005,0.002,0.001,5
825,-0.0012000000000004355,0.23076923076923078,1,1,11,13,10,3,8,16,10,2,0.1,"[0, 20, 40]",0.0005,0.002,0.0015,1
826,0.007169999999998451,0.425,2,6,32,40,34,6,8,16,10,2,0.1,"[0, 20, 40]",0.0005,0.002,0.0015,3
827,0.01325999999999666,0.45161290322580644,3,8,51,62,56,6,8,16,10,2,0.1,"[0, 20, 40]",0.0005,0.002,0.0015,5
828,0.003909999999999898,0.6111111111111112,4,4,10,18,17,1,8,16,10,2,0.2,"[0, 20, 40]",0.0003,0.001,0.001,1
829,0.0011399999999995583,0.4146341463414634,6,7,28,41,37,4,8,16,10,2,0.2,"[0, 20, 40]",0.0003,0.001,0.001,3
830,0.005579999999999139,0.4727272727272727,7,11,37,55,49,6,8,16,10,2,0.2,"[0, 20, 40]",0.0003,0.001,0.001,5
831,0.0012299999999999946,0.5,4,2,12,18,17,1,8,16,10,2,0.2,"[0, 20, 40]",0.0003,0.001,0.0015,1
832,-0.002700000000000393,0.34146341463414637,6,4,31,41,37,4,8,16,10,2,0.2,"[0, 20, 40]",0.0003,0.001,0.0015,3
833,-0.0011600000000008843,0.38181818181818183,8,5,42,55,49,6,8,16,10,2,0.2,"[0, 20, 40]",0.0003,0.001,0.0015,5
834,0.0034199999999998537,0.6111111111111112,1,5,12,18,17,1,8,16,10,2,0.2,"[0, 20, 40]",0.0003,0.0015,0.001,1
835,0.0007799999999994785,0.4146341463414634,1,8,32,41,37,4,8,16,10,2,0.2,"[0, 20, 40]",0.0003,0.0015,0.001,3
836,0.003959999999998905,0.45454545454545453,1,12,42,55,49,6,8,16,10,2,0.2,"[0, 20, 40]",0.0003,0.0015,0.001,5
837,5.999999999982568e-05,0.4444444444444444,1,2,15,18,17,1,8,16,10,2,0.2,"[0, 20, 40]",0.0003,0.0015,0.0015,1
838,-0.0037400000000005953,0.3170731707317073,1,4,36,41,37,4,8,16,10,2,0.2,"[0, 20, 40]",0.0003,0.0015,0.0015,3
839,-0.003200000000001418,0.34545454545454546,1,5,49,55,49,6,8,16,10,2,0.2,"[0, 20, 40]",0.0003,0.0015,0.0015,5
840,0.0033599999999999615,0.6111111111111112,0,5,13,18,17,1,8,16,10,2,0.2,"[0, 20, 40]",0.0003,0.002,0.001,1
841,0.0007199999999995863,0.4146341463414634,0,8,33,41,37,4,8,16,10,2,0.2,"[0, 20, 40]",0.0003,0.002,0.001,3
842,0.0038999999999990128,0.45454545454545453,0,12,43,55,49,6,8,16,10,2,0.2,"[0, 20, 40]",0.0003,0.002,0.001,5
843,-6.648869822767356e-17,0.4444444444444444,0,2,16,18,17,1,8,16,10,2,0.2,"[0, 20, 40]",0.0003,0.002,0.0015,1
844,-0.0038000000000004874,0.3170731707317073,0,4,37,41,37,4,8,16,10,2,0.2,"[0, 20, 40]",0.0003,0.002,0.0015,3
845,-0.00326000000000131,0.34545454545454546,0,5,50,55,49,6,8,16,10,2,0.2,"[0, 20, 40]",0.0003,0.002,0.0015,5
846,0.0004899999999999676,0.5,0,2,4,6,6,0,8,16,10,2,0.2,"[0, 20, 40]",0.0005,0.001,0.001,1
847,0.0029299999999998737,0.5,3,5,12,20,19,1,8,16,10,2,0.2,"[0, 20, 40]",0.0005,0.001,0.001,3
848,0.006739999999999276,0.5277777777777778,7,8,21,36,35,1,8,16,10,2,0.2,"[0, 20, 40]",0.0005,0.001,0.001,5
849,-0.0005900000000000575,0.3333333333333333,0,1,5,6,6,0,8,16,10,2,0.2,"[0, 20, 40]",0.0005,0.001,0.0015,1
850,0.0008499999999997363,0.4,3,3,14,20,19,1,8,16,10,2,0.2,"[0, 20, 40]",0.0005,0.001,0.0015,3
851,0.004219999999998918,0.4444444444444444,7,5,24,36,35,1,8,16,10,2,0.2,"[0, 20, 40]",0.0005,0.001,0.0015,5
852,0.0004899999999999676,0.5,0,2,4,6,6,0,8,16,10,2,0.2,"[0, 20, 40]",0.0005,0.0015,0.001,1
853,0.0033699999999997035,0.5,1,5,14,20,19,1,8,16,10,2,0.2,"[0, 20, 40]",0.0005,0.0015,0.001,3
854,0.007329999999998537,0.5277777777777778,1,8,27,36,35,1,8,16,10,2,0.2,"[0, 20, 40]",0.0005,0.0015,0.001,5
855,-0.0005900000000000575,0.3333333333333333,0,1,5,6,6,0,8,16,10,2,0.2,"[0, 20, 40]",0.0005,0.0015,0.0015,1
856,0.0012899999999995665,0.4,1,3,16,20,19,1,8,16,10,2,0.2,"[0, 20, 40]",0.0005,0.0015,0.0015,3
857,0.004809999999998181,0.4444444444444444,1,5,30,36,35,1,8,16,10,2,0.2,"[0, 20, 40]",0.0005,0.0015,0.0015,5
858,0.0004899999999999676,0.5,0,2,4,6,6,0,8,16,10,2,0.2,"[0, 20, 40]",0.0005,0.002,0.001,1
859,0.003869999999999703,0.5,1,5,14,20,19,1,8,16,10,2,0.2,"[0, 20, 40]",0.0005,0.002,0.001,3
860,0.007829999999998534,0.5277777777777778,1,8,27,36,35,1,8,16,10,2,0.2,"[0, 20, 40]",0.0005,0.002,0.001,5
861,-0.0005900000000000575,0.3333333333333333,0,1,5,6,6,0,8,16,10,2,0.2,"[0, 20, 40]",0.0005,0.002,0.0015,1
862,0.0017899999999995662,0.4,1,3,16,20,19,1,8,16,10,2,0.2,"[0, 20, 40]",0.0005,0.002,0.0015,3
863,0.00530999999999818,0.4444444444444444,1,5,30,36,35,1,8,16,10,2,0.2,"[0, 20, 40]",0.0005,0.002,0.0015,5
864,0.017119999999998744,0.6595744680851063,13,15,19,47,29,18,8,16,15,1,0.1,"[0, 20, 40]",0.0003,0.001,0.001,1
865,0.026149999999997363,0.5773195876288659,22,27,48,97,64,33,8,16,15,1,0.1,"[0, 20, 40]",0.0003,0.001,0.001,3
866,0.03298999999999693,0.5666666666666667,27,31,62,120,83,37,8,16,15,1,0.1,"[0, 20, 40]",0.0003,0.001,0.001,5
867,0.00919999999999871,0.5319148936170213,14,6,27,47,29,18,8,16,15,1,0.1,"[0, 20, 40]",0.0003,0.001,0.0015,1
868,0.013489999999996987,0.4639175257731959,23,13,61,97,64,33,8,16,15,1,0.1,"[0, 20, 40]",0.0003,0.001,0.0015,3
869,0.019169999999996728,0.4666666666666667,29,15,76,120,83,37,8,16,15,1,0.1,"[0, 20, 40]",0.0003,0.001,0.0015,5
870,0.018329999999998063,0.6382978723404256,5,17,25,47,29,18,8,16,15,1,0.1,"[0, 20, 40]",0.0003,0.0015,0.001,1
871,0.027879999999996435,0.5567010309278351,9,29,59,97,64,33,8,16,15,1,0.1,"[0, 20, 40]",0.0003,0.0015,0.001,3
872,0.03273999999999581,0.5416666666666666,9,33,78,120,83,37,8,16,15,1,0.1,"[0, 20, 40]",0.0003,0.0015,0.001,5
873,0.011409999999997915,0.5106382978723404,7,6,34,47,29,18,8,16,15,1,0.1,"[0, 20, 40]",0.0003,0.0015,0.0015,1
874,0.016219999999995953,0.44329896907216493,11,13,73,97,64,33,8,16,15,1,0.1,"[0, 20, 40]",0.0003,0.0015,0.0015,3
875,0.020419999999995497,0.44166666666666665,12,15,93,120,83,37,8,16,15,1,0.1,"[0, 20, 40]",0.0003,0.0015,0.0015,5
876,0.018359999999998097,0.6170212765957447,3,17,27,47,29,18,8,16,15,1,0.1,"[0, 20, 40]",0.0003,0.002,0.001,1
877,0.029299999999996478,0.5463917525773195,6,29,62,97,64,33,8,16,15,1,0.1,"[0, 20, 40]",0.0003,0.002,0.001,3
878,0.03415999999999585,0.5333333333333333,6,33,81,120,83,37,8,16,15,1,0.1,"[0, 20, 40]",0.0003,0.002,0.001,5
879,0.011859999999998148,0.48936170212765956,3,6,38,47,29,18,8,16,15,1,0.1,"[0, 20, 40]",0.0003,0.002,0.0015,1
880,0.018059999999996187,0.4329896907216495,6,13,78,97,64,33,8,16,15,1,0.1,"[0, 20, 40]",0.0003,0.002,0.0015,3
881,0.022759999999995735,0.43333333333333335,7,15,98,120,83,37,8,16,15,1,0.1,"[0, 20, 40]",0.0003,0.002,0.0015,5
882,0.005749999999999896,0.7272727272727273,5,3,3,11,7,4,8,16,15,1,0.1,"[0, 20, 40]",0.0005,0.001,0.001,1
883,0.021399999999998778,0.7083333333333334,16,14,18,48,33,15,8,16,15,1,0.1,"[0, 20, 40]",0.0005,0.001,0.001,3
884,0.02555999999999815,0.6301369863013698,23,17,33,73,57,16,8,16,15,1,0.1,"[0, 20, 40]",0.0005,0.001,0.001,5
885,0.003949999999999816,0.6363636363636364,6,1,4,11,7,4,8,16,15,1,0.1,"[0, 20, 40]",0.0005,0.001,0.0015,1
886,0.014079999999998517,0.5833333333333334,17,7,24,48,33,15,8,16,15,1,0.1,"[0, 20, 40]",0.0005,0.001,0.0015,3
887,0.019739999999997895,0.547945205479452,24,10,39,73,57,16,8,16,15,1,0.1,"[0, 20, 40]",0.0005,0.001,0.0015,5
888,0.0034099999999997227,0.5454545454545454,1,3,7,11,7,4,8,16,15,1,0.1,"[0, 20, 40]",0.0005,0.0015,0.001,1
889,0.022189999999998405,0.6666666666666666,8,14,26,48,33,15,8,16,15,1,0.1,"[0, 20, 40]",0.0005,0.0015,0.001,3
890,0.028739999999997726,0.6027397260273972,13,17,43,73,57,16,8,16,15,1,0.1,"[0, 20, 40]",0.0005,0.0015,0.001,5
891,0.0021099999999996434,0.45454545454545453,2,1,8,11,7,4,8,16,15,1,0.1,"[0, 20, 40]",0.0005,0.0015,0.0015,1
892,0.01536999999999814,0.5416666666666666,9,7,32,48,33,15,8,16,15,1,0.1,"[0, 20, 40]",0.0005,0.0015,0.0015,3
893,0.023419999999997464,0.5205479452054794,14,10,49,73,57,16,8,16,15,1,0.1,"[0, 20, 40]",0.0005,0.0015,0.0015,5
894,0.003909999999999723,0.5454545454545454,1,3,7,11,7,4,8,16,15,1,0.1,"[0, 20, 40]",0.0005,0.002,0.001,1
895,0.022059999999998,0.6458333333333334,4,14,30,48,33,15,8,16,15,1,0.1,"[0, 20, 40]",0.0005,0.002,0.001,3
896,0.02818999999999707,0.5753424657534246,6,17,50,73,57,16,8,16,15,1,0.1,"[0, 20, 40]",0.0005,0.002,0.001,5
897,0.0031099999999996434,0.45454545454545453,2,1,8,11,7,4,8,16,15,1,0.1,"[0, 20, 40]",0.0005,0.002,0.0015,1
898,0.015739999999997728,0.5208333333333334,5,7,36,48,33,15,8,16,15,1,0.1,"[0, 20, 40]",0.0005,0.002,0.0015,3
899,0.023369999999996813,0.4931506849315068,7,10,56,73,57,16,8,16,15,1,0.1,"[0, 20, 40]",0.0005,0.002,0.0015,5
900,0.008579999999999295,0.6956521739130435,8,6,9,23,18,5,8,16,15,1,0.2,"[0, 20, 40]",0.0003,0.001,0.001,1
901,0.008709999999998197,0.5217391304347826,10,9,27,46,37,9,8,16,15,1,0.2,"[0, 20, 40]",0.0003,0.001,0.001,3
902,0.013679999999998263,0.5254237288135594,13,12,34,59,48,11,8,16,15,1,0.2,"[0, 20, 40]",0.0003,0.001,0.001,5
903,0.00438999999999949,0.5652173913043478,8,2,13,23,18,5,8,16,15,1,0.2,"[0, 20, 40]",0.0003,0.001,0.0015,1
904,0.004009999999998151,0.43478260869565216,10,4,32,46,37,9,8,16,15,1,0.2,"[0, 20, 40]",0.0003,0.001,0.0015,3
905,0.0078199999999984,0.4406779661016949,13,6,40,59,48,11,8,16,15,1,0.2,"[0, 20, 40]",0.0003,0.001,0.0015,5
906,0.009849999999999066,0.6521739130434783,4,7,12,23,18,5,8,16,15,1,0.2,"[0, 20, 40]",0.0003,0.0015,0.001,1
907,0.010199999999997855,0.5,4,10,32,46,37,9,8,16,15,1,0.2,"[0, 20, 40]",0.0003,0.0015,0.001,3
908,0.01346999999999778,0.4915254237288136,4,13,42,59,48,11,8,16,15,1,0.2,"[0, 20, 40]",0.0003,0.0015,0.001,5
909,0.005659999999999151,0.5217391304347826,4,2,17,23,18,5,8,16,15,1,0.2,"[0, 20, 40]",0.0003,0.0015,0.0015,1
910,0.005499999999997704,0.41304347826086957,4,4,38,46,37,9,8,16,15,1,0.2,"[0, 20, 40]",0.0003,0.0015,0.0015,3
911,0.007609999999997806,0.4067796610169492,4,6,49,59,48,11,8,16,15,1,0.2,"[0, 20, 40]",0.0003,0.0015,0.0015,5
912,0.009379999999999097,0.6086956521739131,2,7,14,23,18,5,8,16,15,1,0.2,"[0, 20, 40]",0.0003,0.002,0.001,1
913,0.009729999999997891,0.4782608695652174,2,10,34,46,37,9,8,16,15,1,0.2,"[0, 20, 40]",0.0003,0.002,0.001,3
914,0.012999999999997808,0.4745762711864407,2,13,44,59,48,11,8,16,15,1,0.2,"[0, 20, 40]",0.0003,0.002,0.001,5
915,0.005189999999999185,0.4782608695652174,2,2,19,23,18,5,8,16,15,1,0.2,"[0, 20, 40]",0.0003,0.002,0.0015,1
916,0.005029999999997733,0.391304347826087,2,4,40,46,37,9,8,16,15,1,0.2,"[0, 20, 40]",0.0003,0.002,0.0015,3
917,0.007139999999997835,0.3898305084745763,2,6,51,59,48,11,8,16,15,1,0.2,"[0, 20, 40]",0.0003,0.002,0.0015,5
918,0.0017899999999999566,0.6,3,0,2,5,4,1,8,16,15,1,0.2,"[0, 20, 40]",0.0005,0.001,0.001,1
919,0.009019999999999114,0.6153846153846154,8,5,13,26,21,5,8,16,15,1,0.2,"[0, 20, 40]",0.0005,0.001,0.001,3
920,0.011459999999998553,0.5365853658536586,11,8,22,41,36,5,8,16,15,1,0.2,"[0, 20, 40]",0.0005,0.001,0.001,5
921,0.0017899999999999566,0.6,3,0,2,5,4,1,8,16,15,1,0.2,"[0, 20, 40]",0.0005,0.001,0.0015,1
922,0.007239999999998941,0.5384615384615384,8,3,15,26,21,5,8,16,15,1,0.2,"[0, 20, 40]",0.0005,0.001,0.0015,3
923,0.011179999999998379,0.4878048780487805,11,6,24,41,36,5,8,16,15,1,0.2,"[0, 20, 40]",0.0005,0.001,0.0015,5
924,0.0005399999999995959,0.4,1,0,4,5,4,1,8,16,15,1,0.2,"[0, 20, 40]",0.0005,0.0015,0.001,1
925,0.00925999999999869,0.5769230769230769,4,5,17,26,21,5,8,16,15,1,0.2,"[0, 20, 40]",0.0005,0.0015,0.001,3
926,0.012089999999998076,0.5121951219512195,5,8,28,41,36,5,8,16,15,1,0.2,"[0, 20, 40]",0.0005,0.0015,0.001,5
927,0.0005399999999995959,0.4,1,0,4,5,4,1,8,16,15,1,0.2,"[0, 20, 40]",0.0005,0.0015,0.0015,1
928,0.007479999999998517,0.5,4,3,19,26,21,5,8,16,15,1,0.2,"[0, 20, 40]",0.0005,0.0015,0.0015,3
929,0.0118099999999979,0.4634146341463415,5,6,30,41,36,5,8,16,15,1,0.2,"[0, 20, 40]",0.0005,0.0015,0.0015,5
930,0.001039999999999596,0.4,1,0,4,5,4,1,8,16,15,1,0.2,"[0, 20, 40]",0.0005,0.002,0.001,1
931,0.009289999999998445,0.5769230769230769,1,5,20,26,21,5,8,16,15,1,0.2,"[0, 20, 40]",0.0005,0.002,0.001,3
932,0.011799999999997791,0.5121951219512195,1,8,32,41,36,5,8,16,15,1,0.2,"[0, 20, 40]",0.0005,0.002,0.001,5
933,0.001039999999999596,0.4,1,0,4,5,4,1,8,16,15,1,0.2,"[0, 20, 40]",0.0005,0.002,0.0015,1
934,0.007509999999998275,0.5,1,3,22,26,21,5,8,16,15,1,0.2,"[0, 20, 40]",0.0005,0.002,0.0015,3
935,0.011519999999997614,0.4634146341463415,1,6,34,41,36,5,8,16,15,1,0.2,"[0, 20, 40]",0.0005,0.002,0.0015,5
936,0.005709999999999231,0.5,8,7,19,34,24,10,8,16,15,2,0.1,"[0, 20, 40]",0.0003,0.001,0.001,1
937,0.01298999999999774,0.4936708860759494,16,17,46,79,60,19,8,16,15,2,0.1,"[0, 20, 40]",0.0003,0.001,0.001,3
938,0.01906999999999762,0.5,20,21,57,98,77,21,8,16,15,2,0.1,"[0, 20, 40]",0.0003,0.001,0.001,5
939,0.006069999999999426,0.47058823529411764,8,5,21,34,24,10,8,16,15,2,0.1,"[0, 20, 40]",0.0003,0.001,0.0015,1
940,0.011589999999997547,0.4430379746835443,16,12,51,79,60,19,8,16,15,2,0.1,"[0, 20, 40]",0.0003,0.001,0.0015,3
941,0.016509999999997596,0.4489795918367347,21,14,63,98,77,21,8,16,15,2,0.1,"[0, 20, 40]",0.0003,0.001,0.0015,5
942,0.005129999999998765,0.47058823529411764,2,8,24,34,24,10,8,16,15,2,0.1,"[0, 20, 40]",0.0003,0.0015,0.001,1
943,0.013509999999996932,0.46835443037974683,6,18,55,79,60,19,8,16,15,2,0.1,"[0, 20, 40]",0.0003,0.0015,0.001,3
944,0.017829999999996606,0.46938775510204084,6,22,70,98,77,21,8,16,15,2,0.1,"[0, 20, 40]",0.0003,0.0015,0.001,5
945,0.005489999999998847,0.4411764705882353,2,5,27,34,24,10,8,16,15,2,0.1,"[0, 20, 40]",0.0003,0.0015,0.0015,1
946,0.012109999999996629,0.4177215189873418,6,12,61,79,60,19,8,16,15,2,0.1,"[0, 20, 40]",0.0003,0.0015,0.0015,3
947,0.015769999999996478,0.41836734693877553,7,14,77,98,77,21,8,16,15,2,0.1,"[0, 20, 40]",0.0003,0.0015,0.0015,5
948,0.006129999999998765,0.47058823529411764,2,8,24,34,24,10,8,16,15,2,0.1,"[0, 20, 40]",0.0003,0.002,0.001,1
949,0.015899999999996934,0.46835443037974683,5,18,56,79,60,19,8,16,15,2,0.1,"[0, 20, 40]",0.0003,0.002,0.001,3
950,0.02021999999999661,0.46938775510204084,5,22,71,98,77,21,8,16,15,2,0.1,"[0, 20, 40]",0.0003,0.002,0.001,5
951,0.006489999999998847,0.4411764705882353,2,5,27,34,24,10,8,16,15,2,0.1,"[0, 20, 40]",0.0003,0.002,0.0015,1
952,0.01449999999999663,0.4177215189873418,5,12,62,79,60,19,8,16,15,2,0.1,"[0, 20, 40]",0.0003,0.002,0.0015,3
953,0.01865999999999648,0.41836734693877553,6,14,78,98,77,21,8,16,15,2,0.1,"[0, 20, 40]",0.0003,0.002,0.0015,5
954,0.00455999999999996,0.5833333333333334,5,2,5,12,9,3,8,16,15,2,0.1,"[0, 20, 40]",0.0005,0.001,0.001,1
955,0.016949999999999143,0.6666666666666666,13,11,15,39,33,6,8,16,15,2,0.1,"[0, 20, 40]",0.0005,0.001,0.001,3
956,0.023159999999998473,0.6229508196721312,20,14,27,61,55,6,8,16,15,2,0.1,"[0, 20, 40]",0.0005,0.001,0.001,5
957,0.0027599999999998806,0.5,5,1,6,12,9,3,8,16,15,2,0.1,"[0, 20, 40]",0.0005,0.001,0.0015,1
958,0.013139999999998774,0.5641025641025641,13,7,19,39,33,6,8,16,15,2,0.1,"[0, 20, 40]",0.0005,0.001,0.0015,3
959,0.02084999999999811,0.5573770491803278,20,10,31,61,55,6,8,16,15,2,0.1,"[0, 20, 40]",0.0005,0.001,0.0015,5
960,0.002219999999999788,0.4166666666666667,1,2,9,12,9,3,8,16,15,2,0.1,"[0, 20, 40]",0.0005,0.0015,0.001,1
961,0.01623999999999877,0.6153846153846154,5,11,23,39,33,6,8,16,15,2,0.1,"[0, 20, 40]",0.0005,0.0015,0.001,3
962,0.024839999999998037,0.5901639344262295,10,14,37,61,55,6,8,16,15,2,0.1,"[0, 20, 40]",0.0005,0.0015,0.001,5
963,0.0004199999999997088,0.3333333333333333,1,1,10,12,9,3,8,16,15,2,0.1,"[0, 20, 40]",0.0005,0.0015,0.0015,1
964,0.012429999999998399,0.5128205128205128,5,7,27,39,33,6,8,16,15,2,0.1,"[0, 20, 40]",0.0005,0.0015,0.0015,3
965,0.022529999999997684,0.5245901639344263,10,10,41,61,55,6,8,16,15,2,0.1,"[0, 20, 40]",0.0005,0.0015,0.0015,5
966,0.002719999999999788,0.4166666666666667,1,2,9,12,9,3,8,16,15,2,0.1,"[0, 20, 40]",0.0005,0.002,0.001,1
967,0.015979999999998676,0.5897435897435898,3,11,25,39,33,6,8,16,15,2,0.1,"[0, 20, 40]",0.0005,0.002,0.001,3
968,0.024159999999997708,0.5573770491803278,5,14,42,61,55,6,8,16,15,2,0.1,"[0, 20, 40]",0.0005,0.002,0.001,5
969,0.0009199999999997088,0.3333333333333333,1,1,10,12,9,3,8,16,15,2,0.1,"[0, 20, 40]",0.0005,0.002,0.0015,1
970,0.012169999999998305,0.48717948717948717,3,7,29,39,33,6,8,16,15,2,0.1,"[0, 20, 40]",0.0005,0.002,0.0015,3
971,0.021849999999997344,0.4918032786885246,5,10,46,61,55,6,8,16,15,2,0.1,"[0, 20, 40]",0.0005,0.002,0.0015,5
972,0.0050599999999998155,0.625,5,4,7,16,15,1,8,16,15,2,0.2,"[0, 20, 40]",0.0003,0.001,0.001,1
973,0.007089999999998951,0.5128205128205128,7,9,23,39,35,4,8,16,15,2,0.2,"[0, 20, 40]",0.0003,0.001,0.001,3
974,0.012719999999998908,0.5384615384615384,9,13,30,52,46,6,8,16,15,2,0.2,"[0, 20, 40]",0.0003,0.001,0.001,5
975,0.00499999999999992,0.5625,5,3,8,16,15,1,8,16,15,2,0.2,"[0, 20, 40]",0.0003,0.001,0.0015,1
976,0.0050899999999987205,0.4358974358974359,7,6,26,39,35,4,8,16,15,2,0.2,"[0, 20, 40]",0.0003,0.001,0.0015,3
977,0.009559999999998845,0.46153846153846156,10,8,34,52,46,6,8,16,15,2,0.2,"[0, 20, 40]",0.0003,0.001,0.0015,5
978,0.004589999999999568,0.5625,1,5,10,16,15,1,8,16,15,2,0.2,"[0, 20, 40]",0.0003,0.0015,0.001,1
979,0.006099999999998573,0.46153846153846156,2,10,27,39,35,4,8,16,15,2,0.2,"[0, 20, 40]",0.0003,0.0015,0.001,3
980,0.010049999999998626,0.4807692307692308,2,14,36,52,46,6,8,16,15,2,0.2,"[0, 20, 40]",0.0003,0.0015,0.001,5
981,0.004529999999999565,0.5,1,3,12,16,15,1,8,16,15,2,0.2,"[0, 20, 40]",0.0003,0.0015,0.0015,1
982,0.004099999999998233,0.38461538461538464,2,6,31,39,35,4,8,16,15,2,0.2,"[0, 20, 40]",0.0003,0.0015,0.0015,3
983,0.00738999999999846,0.40384615384615385,3,8,41,52,46,6,8,16,15,2,0.2,"[0, 20, 40]",0.0003,0.0015,0.0015,5
984,0.00508999999999957,0.5625,1,5,10,16,15,1,8,16,15,2,0.2,"[0, 20, 40]",0.0003,0.002,0.001,1
985,0.007099999999998575,0.46153846153846156,2,10,27,39,35,4,8,16,15,2,0.2,"[0, 20, 40]",0.0003,0.002,0.001,3
986,0.011049999999998623,0.4807692307692308,2,14,36,52,46,6,8,16,15,2,0.2,"[0, 20, 40]",0.0003,0.002,0.001,5
987,0.005029999999999565,0.5,1,3,12,16,15,1,8,16,15,2,0.2,"[0, 20, 40]",0.0003,0.002,0.0015,1
988,0.005099999999998233,0.38461538461538464,2,6,31,39,35,4,8,16,15,2,0.2,"[0, 20, 40]",0.0003,0.002,0.0015,3
989,0.008889999999998458,0.40384615384615385,3,8,41,52,46,6,8,16,15,2,0.2,"[0, 20, 40]",0.0003,0.002,0.0015,5
990,0.0007899999999999566,0.4,1,1,3,5,5,0,8,16,15,2,0.2,"[0, 20, 40]",0.0005,0.001,0.001,1
991,0.006129999999999433,0.5789473684210527,4,5,10,19,18,1,8,16,15,2,0.2,"[0, 20, 40]",0.0005,0.001,0.001,3
992,0.010459999999999019,0.5428571428571428,9,8,18,35,34,1,8,16,15,2,0.2,"[0, 20, 40]",0.0005,0.001,0.001,5
993,0.0012899999999999565,0.4,1,1,3,5,5,0,8,16,15,2,0.2,"[0, 20, 40]",0.0005,0.001,0.0015,1
994,0.006819999999999177,0.5263157894736842,4,4,11,19,18,1,8,16,15,2,0.2,"[0, 20, 40]",0.0005,0.001,0.0015,3
995,0.012649999999998761,0.5142857142857142,9,7,19,35,34,1,8,16,15,2,0.2,"[0, 20, 40]",0.0005,0.001,0.0015,5
996,0.000739999999999741,0.4,0,1,4,5,5,0,8,16,15,2,0.2,"[0, 20, 40]",0.0005,0.0015,0.001,1
997,0.006569999999999153,0.5789473684210527,1,5,13,19,18,1,8,16,15,2,0.2,"[0, 20, 40]",0.0005,0.0015,0.001,3
998,0.012289999999998687,0.5428571428571428,4,8,23,35,34,1,8,16,15,2,0.2,"[0, 20, 40]",0.0005,0.0015,0.001,5
999,0.0012399999999997409,0.4,0,1,4,5,5,0,8,16,15,2,0.2,"[0, 20, 40]",0.0005,0.0015,0.0015,1
1000,0.0072599999999988975,0.5263157894736842,1,4,14,19,18,1,8,16,15,2,0.2,"[0, 20, 40]",0.0005,0.0015,0.0015,3
1001,0.01447999999999843,0.5142857142857142,4,7,24,35,34,1,8,16,15,2,0.2,"[0, 20, 40]",0.0005,0.0015,0.0015,5
1002,0.000739999999999741,0.4,0,1,4,5,5,0,8,16,15,2,0.2,"[0, 20, 40]",0.0005,0.002,0.001,1
1003,0.007069999999999153,0.5789473684210527,1,5,13,19,18,1,8,16,15,2,0.2,"[0, 20, 40]",0.0005,0.002,0.001,3
1004,0.013209999999998499,0.5428571428571428,2,8,25,35,34,1,8,16,15,2,0.2,"[0, 20, 40]",0.0005,0.002,0.001,5
1005,0.0012399999999997409,0.4,0,1,4,5,5,0,8,16,15,2,0.2,"[0, 20, 40]",0.0005,0.002,0.0015,1
1006,0.007759999999998898,0.5263157894736842,1,4,14,19,18,1,8,16,15,2,0.2,"[0, 20, 40]",0.0005,0.002,0.0015,3
1007,0.01539999999999824,0.5142857142857142,2,7,26,35,34,1,8,16,15,2,0.2,"[0, 20, 40]",0.0005,0.002,0.0015,5
1008,0.01729000000000021,0.717391304347826,16,17,13,46,29,17,8,16,20,1,0.1,"[0, 20, 40]",0.0003,0.001,0.001,1
1009,0.032660000000000015,0.6931818181818182,26,31,31,88,59,29,8,16,20,1,0.1,"[0, 20, 40]",0.0003,0.001,0.001,3
1010,0.04146999999999975,0.6909090909090909,34,37,39,110,77,33,8,16,20,1,0.1,"[0, 20, 40]",0.0003,0.001,0.001,5
1011,0.013520000000000271,0.5869565217391305,17,10,19,46,29,17,8,16,20,1,0.1,"[0, 20, 40]",0.0003,0.001,0.0015,1
1012,0.019580000000000115,0.5340909090909091,26,17,45,88,59,29,8,16,20,1,0.1,"[0, 20, 40]",0.0003,0.001,0.0015,3
1013,0.03150999999999988,0.5727272727272728,35,22,53,110,76,34,8,16,20,1,0.1,"[0, 20, 40]",0.0003,0.001,0.0015,5
1014,0.020069999999999928,0.6956521739130435,9,19,18,46,29,17,8,16,20,1,0.1,"[0, 20, 40]",0.0003,0.0015,0.001,1
1015,0.034979999999999296,0.6477272727272727,13,34,41,88,59,29,8,16,20,1,0.1,"[0, 20, 40]",0.0003,0.0015,0.001,3
1016,0.04427999999999881,0.6454545454545455,17,41,52,110,77,33,8,16,20,1,0.1,"[0, 20, 40]",0.0003,0.0015,0.001,5
1017,0.017799999999999993,0.5652173913043478,12,10,24,46,29,17,8,16,20,1,0.1,"[0, 20, 40]",0.0003,0.0015,0.0015,1
1018,0.023399999999999366,0.48863636363636365,15,18,55,88,59,29,8,16,20,1,0.1,"[0, 20, 40]",0.0003,0.0015,0.0015,3
1019,0.0347599999999988,0.5181818181818182,20,23,67,110,76,34,8,16,20,1,0.1,"[0, 20, 40]",0.0003,0.0015,0.0015,5
1020,0.02098999999999958,0.6956521739130435,4,19,23,46,29,17,8,16,20,1,0.1,"[0, 20, 40]",0.0003,0.002,0.001,1
1021,0.037949999999999075,0.6477272727272727,8,34,46,88,59,29,8,16,20,1,0.1,"[0, 20, 40]",0.0003,0.002,0.001,3
1022,0.0441699999999983,0.6422018348623854,8,40,61,109,77,32,8,16,20,1,0.1,"[0, 20, 40]",0.0003,0.002,0.001,5
1023,0.019429999999999798,0.5652173913043478,6,10,30,46,29,17,8,16,20,1,0.1,"[0, 20, 40]",0.0003,0.002,0.0015,1
1024,0.027369999999999124,0.48863636363636365,10,18,60,88,59,29,8,16,20,1,0.1,"[0, 20, 40]",0.0003,0.002,0.0015,3
1025,0.035649999999998294,0.5137614678899083,11,22,76,109,76,33,8,16,20,1,0.1,"[0, 20, 40]",0.0003,0.002,0.0015,5
1026,0.006539999999999852,0.8181818181818182,5,4,2,11,7,4,8,16,20,1,0.1,"[0, 20, 40]",0.0005,0.001,0.001,1
1027,0.021089999999999037,0.7111111111111111,15,15,15,45,32,13,8,16,20,1,0.1,"[0, 20, 40]",0.0005,0.001,0.001,3
1028,0.029159999999998854,0.6911764705882353,21,22,25,68,54,14,8,16,20,1,0.1,"[0, 20, 40]",0.0005,0.001,0.001,5
1029,0.003619999999999652,0.6363636363636364,6,1,4,11,7,4,8,16,20,1,0.1,"[0, 20, 40]",0.0005,0.001,0.0015,1
1030,0.017499999999998683,0.5909090909090909,15,9,20,44,31,13,8,16,20,1,0.1,"[0, 20, 40]",0.0005,0.001,0.0015,3
1031,0.021529999999998592,0.5671641791044776,21,13,33,67,53,14,8,16,20,1,0.1,"[0, 20, 40]",0.0005,0.001,0.0015,5
1032,0.005479999999999959,0.6363636363636364,1,5,5,11,7,4,8,16,20,1,0.1,"[0, 20, 40]",0.0005,0.0015,0.001,1
1033,0.022689999999999082,0.6666666666666666,8,16,21,45,32,13,8,16,20,1,0.1,"[0, 20, 40]",0.0005,0.0015,0.001,3
1034,0.0331099999999987,0.6617647058823529,13,23,32,68,54,14,8,16,20,1,0.1,"[0, 20, 40]",0.0005,0.0015,0.001,5
1035,0.0012399999999997166,0.36363636363636365,2,1,8,11,7,4,8,16,20,1,0.1,"[0, 20, 40]",0.0005,0.0015,0.0015,1
1036,0.017279999999998682,0.5227272727272727,8,9,27,44,31,13,8,16,20,1,0.1,"[0, 20, 40]",0.0005,0.0015,0.0015,3
1037,0.023659999999998387,0.5223880597014925,13,13,41,67,53,14,8,16,20,1,0.1,"[0, 20, 40]",0.0005,0.0015,0.0015,5
1038,0.005979999999999959,0.6363636363636364,1,5,5,11,7,4,8,16,20,1,0.1,"[0, 20, 40]",0.0005,0.002,0.001,1
1039,0.024309999999998593,0.6666666666666666,5,16,24,45,32,13,8,16,20,1,0.1,"[0, 20, 40]",0.0005,0.002,0.001,3
1040,0.03438999999999761,0.6617647058823529,7,23,38,68,54,14,8,16,20,1,0.1,"[0, 20, 40]",0.0005,0.002,0.001,5
1041,0.0022399999999997166,0.36363636363636365,2,1,8,11,7,4,8,16,20,1,0.1,"[0, 20, 40]",0.0005,0.002,0.0015,1
1042,0.02025999999999845,0.5227272727272727,6,9,29,44,31,13,8,16,20,1,0.1,"[0, 20, 40]",0.0005,0.002,0.0015,3
1043,0.02629999999999754,0.5223880597014925,8,13,46,67,53,14,8,16,20,1,0.1,"[0, 20, 40]",0.0005,0.002,0.0015,5
1044,0.006990000000000088,0.7391304347826086,10,7,6,23,18,5,8,16,20,1,0.2,"[0, 20, 40]",0.0003,0.001,0.001,1
1045,0.011430000000000308,0.6511627906976745,13,12,18,43,34,9,8,16,20,1,0.2,"[0, 20, 40]",0.0003,0.001,0.001,3
1046,0.016670000000000382,0.6545454545454545,17,16,22,55,44,11,8,16,20,1,0.2,"[0, 20, 40]",0.0003,0.001,0.001,5
1047,0.004409999999999948,0.6086956521739131,10,4,9,23,18,5,8,16,20,1,0.2,"[0, 20, 40]",0.0003,0.001,0.0015,1
1048,0.0071200000000001045,0.5348837209302325,13,7,23,43,34,9,8,16,20,1,0.2,"[0, 20, 40]",0.0003,0.001,0.0015,3
1049,0.014360000000000185,0.5636363636363636,17,11,27,55,44,11,8,16,20,1,0.2,"[0, 20, 40]",0.0003,0.001,0.0015,5
1050,0.009719999999999928,0.7391304347826086,7,8,8,23,18,5,8,16,20,1,0.2,"[0, 20, 40]",0.0003,0.0015,0.001,1
1051,0.014369999999999853,0.6511627906976745,7,13,23,43,34,9,8,16,20,1,0.2,"[0, 20, 40]",0.0003,0.0015,0.001,3
1052,0.020109999999999892,0.6545454545454545,9,18,28,55,44,11,8,16,20,1,0.2,"[0, 20, 40]",0.0003,0.0015,0.001,5
1053,0.007639999999999791,0.6086956521739131,8,4,11,23,18,5,8,16,20,1,0.2,"[0, 20, 40]",0.0003,0.0015,0.0015,1
1054,0.01055999999999966,0.5348837209302325,8,7,28,43,34,9,8,16,20,1,0.2,"[0, 20, 40]",0.0003,0.0015,0.0015,3
1055,0.01673999999999956,0.5454545454545454,10,11,34,55,44,11,8,16,20,1,0.2,"[0, 20, 40]",0.0003,0.0015,0.0015,5
1056,0.010199999999999694,0.7391304347826086,3,8,12,23,18,5,8,16,20,1,0.2,"[0, 20, 40]",0.0003,0.002,0.001,1
1057,0.015889999999999765,0.6511627906976745,4,13,26,43,34,9,8,16,20,1,0.2,"[0, 20, 40]",0.0003,0.002,0.001,3
1058,0.019839999999999653,0.6481481481481481,4,17,33,54,44,10,8,16,20,1,0.2,"[0, 20, 40]",0.0003,0.002,0.001,5
1059,0.008619999999999553,0.6086956521739131,4,4,15,23,18,5,8,16,20,1,0.2,"[0, 20, 40]",0.0003,0.002,0.0015,1
1060,0.01257999999999957,0.5348837209302325,5,7,31,43,34,9,8,16,20,1,0.2,"[0, 20, 40]",0.0003,0.002,0.0015,3
1061,0.016469999999999315,0.5370370370370371,5,10,39,54,44,10,8,16,20,1,0.2,"[0, 20, 40]",0.0003,0.002,0.0015,5
1062,0.0030899999999999235,0.8,3,1,1,5,4,1,8,16,20,1,0.2,"[0, 20, 40]",0.0005,0.001,0.001,1
1063,0.011539999999999412,0.6538461538461539,8,7,11,26,21,5,8,16,20,1,0.2,"[0, 20, 40]",0.0005,0.001,0.001,3
1064,0.016169999999999452,0.65,11,12,17,40,35,5,8,16,20,1,0.2,"[0, 20, 40]",0.0005,0.001,0.001,5
1065,0.0013099999999999206,0.6,3,0,2,5,4,1,8,16,20,1,0.2,"[0, 20, 40]",0.0005,0.001,0.0015,1
1066,0.011249999999999339,0.5769230769230769,8,5,13,26,21,5,8,16,20,1,0.2,"[0, 20, 40]",0.0005,0.001,0.0015,3
1067,0.013379999999999379,0.55,11,8,21,40,35,5,8,16,20,1,0.2,"[0, 20, 40]",0.0005,0.001,0.0015,5
1068,0.00341999999999981,0.8,1,2,2,5,4,1,8,16,20,1,0.2,"[0, 20, 40]",0.0005,0.0015,0.001,1
1069,0.013749999999999287,0.6538461538461539,5,8,13,26,21,5,8,16,20,1,0.2,"[0, 20, 40]",0.0005,0.0015,0.001,3
1070,0.01896999999999903,0.65,6,13,21,40,35,5,8,16,20,1,0.2,"[0, 20, 40]",0.0005,0.0015,0.001,5
1071,-0.0001800000000002364,0.4,1,0,4,5,4,1,8,16,20,1,0.2,"[0, 20, 40]",0.0005,0.0015,0.0015,1
1072,0.011639999999999175,0.5384615384615384,5,5,16,26,21,5,8,16,20,1,0.2,"[0, 20, 40]",0.0005,0.0015,0.0015,3
1073,0.014359999999998912,0.525,6,8,26,40,35,5,8,16,20,1,0.2,"[0, 20, 40]",0.0005,0.0015,0.0015,5
1074,0.00391999999999981,0.8,1,2,2,5,4,1,8,16,20,1,0.2,"[0, 20, 40]",0.0005,0.002,0.001,1
1075,0.01522999999999905,0.6538461538461539,3,8,15,26,21,5,8,16,20,1,0.2,"[0, 20, 40]",0.0005,0.002,0.001,3
1076,0.01972999999999857,0.65,3,13,24,40,35,5,8,16,20,1,0.2,"[0, 20, 40]",0.0005,0.002,0.001,5
1077,0.0003199999999997636,0.4,1,0,4,5,4,1,8,16,20,1,0.2,"[0, 20, 40]",0.0005,0.002,0.0015,1
1078,0.013119999999998933,0.5384615384615384,3,5,18,26,21,5,8,16,20,1,0.2,"[0, 20, 40]",0.0005,0.002,0.0015,3
1079,0.015119999999998454,0.525,3,8,29,40,35,5,8,16,20,1,0.2,"[0, 20, 40]",0.0005,0.002,0.0015,5
1080,0.01109000000000019,0.6060606060606061,10,10,13,33,24,9,8,16,20,2,0.1,"[0, 20, 40]",0.0003,0.001,0.001,1
1081,0.02437999999999976,0.6027397260273972,19,21,33,73,56,17,8,16,20,2,0.1,"[0, 20, 40]",0.0003,0.001,0.001,3
1082,0.03257999999999987,0.6263736263736264,26,27,38,91,72,19,8,16,20,2,0.1,"[0, 20, 40]",0.0003,0.001,0.001,5
1083,0.012270000000000364,0.5454545454545454,10,8,15,33,24,9,8,16,20,2,0.1,"[0, 20, 40]",0.0003,0.001,0.0015,1
1084,0.02505999999999988,0.5342465753424658,19,16,38,73,56,17,8,16,20,2,0.1,"[0, 20, 40]",0.0003,0.001,0.0015,3
1085,0.03598000000000016,0.5777777777777777,27,21,42,90,71,19,8,16,20,2,0.1,"[0, 20, 40]",0.0003,0.001,0.0015,5
1086,0.01136999999999992,0.5757575757575758,4,11,18,33,24,9,8,16,20,2,0.1,"[0, 20, 40]",0.0003,0.0015,0.001,1
1087,0.023729999999999,0.5616438356164384,7,23,43,73,56,17,8,16,20,2,0.1,"[0, 20, 40]",0.0003,0.0015,0.001,3
1088,0.03307999999999889,0.5934065934065934,11,30,50,91,72,19,8,16,20,2,0.1,"[0, 20, 40]",0.0003,0.0015,0.001,5
1089,0.01305000000000009,0.5151515151515151,5,8,20,33,24,9,8,16,20,2,0.1,"[0, 20, 40]",0.0003,0.0015,0.0015,1
1090,0.025409999999999124,0.4931506849315068,8,17,48,73,56,17,8,16,20,2,0.1,"[0, 20, 40]",0.0003,0.0015,0.0015,3
1091,0.036419999999999036,0.5333333333333333,13,22,55,90,71,19,8,16,20,2,0.1,"[0, 20, 40]",0.0003,0.0015,0.0015,5
1092,0.012809999999999806,0.5757575757575758,3,11,19,33,24,9,8,16,20,2,0.1,"[0, 20, 40]",0.0003,0.002,0.001,1
1093,0.02567999999999884,0.5616438356164384,5,23,45,73,56,17,8,16,20,2,0.1,"[0, 20, 40]",0.0003,0.002,0.001,3
1094,0.03274999999999846,0.5934065934065934,5,30,56,91,72,19,8,16,20,2,0.1,"[0, 20, 40]",0.0003,0.002,0.001,5
1095,0.014989999999999979,0.5151515151515151,4,8,21,33,24,9,8,16,20,2,0.1,"[0, 20, 40]",0.0003,0.002,0.0015,1
1096,0.027859999999998965,0.4931506849315068,6,17,50,73,56,17,8,16,20,2,0.1,"[0, 20, 40]",0.0003,0.002,0.0015,3
1097,0.0370899999999986,0.5333333333333333,7,22,61,90,71,19,8,16,20,2,0.1,"[0, 20, 40]",0.0003,0.002,0.0015,5
1098,0.006659999999999951,0.75,5,4,3,12,9,3,8,16,20,2,0.1,"[0, 20, 40]",0.0005,0.001,0.001,1
1099,0.019599999999999427,0.7368421052631579,13,13,12,38,32,6,8,16,20,2,0.1,"[0, 20, 40]",0.0005,0.001,0.001,3
1100,0.02773999999999942,0.711864406779661,20,18,21,59,53,6,8,16,20,2,0.1,"[0, 20, 40]",0.0005,0.001,0.001,5
1101,0.00423999999999975,0.5833333333333334,5,2,5,12,9,3,8,16,20,2,0.1,"[0, 20, 40]",0.0005,0.001,0.0015,1
1102,0.01764999999999905,0.6216216216216216,12,9,16,37,31,6,8,16,20,2,0.1,"[0, 20, 40]",0.0005,0.001,0.0015,3
1103,0.023289999999999058,0.603448275862069,19,12,27,58,52,6,8,16,20,2,0.1,"[0, 20, 40]",0.0005,0.001,0.0015,5
1104,0.005600000000000056,0.5833333333333334,1,5,6,12,9,3,8,16,20,2,0.1,"[0, 20, 40]",0.0005,0.0015,0.001,1
1105,0.019889999999999276,0.6842105263157895,5,14,19,38,32,6,8,16,20,2,0.1,"[0, 20, 40]",0.0005,0.0015,0.001,3
1106,0.030619999999998974,0.6779661016949152,10,19,30,59,53,6,8,16,20,2,0.1,"[0, 20, 40]",0.0005,0.0015,0.001,5
1107,0.0013599999999998145,0.3333333333333333,1,2,9,12,9,3,8,16,20,2,0.1,"[0, 20, 40]",0.0005,0.0015,0.0015,1
1108,0.01561999999999885,0.5405405405405406,4,9,24,37,31,6,8,16,20,2,0.1,"[0, 20, 40]",0.0005,0.0015,0.0015,3
1109,0.02384999999999857,0.5517241379310345,9,12,37,58,52,6,8,16,20,2,0.1,"[0, 20, 40]",0.0005,0.0015,0.0015,5
1110,0.006100000000000057,0.5833333333333334,1,5,6,12,9,3,8,16,20,2,0.1,"[0, 20, 40]",0.0005,0.002,0.001,1
1111,0.020309999999998975,0.6842105263157895,3,14,21,38,32,6,8,16,20,2,0.1,"[0, 20, 40]",0.0005,0.002,0.001,3
1112,0.030699999999998066,0.6779661016949152,5,19,35,59,53,6,8,16,20,2,0.1,"[0, 20, 40]",0.0005,0.002,0.001,5
1113,0.0018599999999998145,0.3333333333333333,1,2,9,12,9,3,8,16,20,2,0.1,"[0, 20, 40]",0.0005,0.002,0.0015,1
1114,0.0168999999999988,0.5405405405405406,3,9,25,37,31,6,8,16,20,2,0.1,"[0, 20, 40]",0.0005,0.002,0.0015,3
1115,0.024789999999997904,0.5517241379310345,5,12,41,58,52,6,8,16,20,2,0.1,"[0, 20, 40]",0.0005,0.002,0.0015,5
1116,0.006469999999999948,0.6875,6,5,5,16,15,1,8,16,20,2,0.2,"[0, 20, 40]",0.0003,0.001,0.001,1
1117,0.01052000000000021,0.5882352941176471,7,11,16,34,31,3,8,16,20,2,0.2,"[0, 20, 40]",0.0003,0.001,0.001,3
1118,0.016650000000000463,0.6304347826086957,11,16,19,46,41,5,8,16,20,2,0.2,"[0, 20, 40]",0.0003,0.001,0.001,5
1119,0.006489999999999965,0.625,6,4,6,16,15,1,8,16,20,2,0.2,"[0, 20, 40]",0.0003,0.001,0.0015,1
1120,0.009310000000000164,0.5,7,8,19,34,31,3,8,16,20,2,0.2,"[0, 20, 40]",0.0003,0.001,0.0015,3
1121,0.017440000000000414,0.5652173913043478,12,12,22,46,41,5,8,16,20,2,0.2,"[0, 20, 40]",0.0003,0.001,0.0015,5
1122,0.007199999999999789,0.6875,3,6,7,16,15,1,8,16,20,2,0.2,"[0, 20, 40]",0.0003,0.0015,0.001,1
1123,0.010590000000000007,0.5882352941176471,2,13,19,34,31,3,8,16,20,2,0.2,"[0, 20, 40]",0.0003,0.0015,0.001,3
1124,0.017220000000000197,0.6304347826086957,4,19,23,46,41,5,8,16,20,2,0.2,"[0, 20, 40]",0.0003,0.0015,0.001,5
1125,0.007719999999999807,0.625,4,4,8,16,15,1,8,16,20,2,0.2,"[0, 20, 40]",0.0003,0.0015,0.0015,1
1126,0.010379999999999959,0.5,3,9,22,34,31,3,8,16,20,2,0.2,"[0, 20, 40]",0.0003,0.0015,0.0015,3
1127,0.017950000000000032,0.5434782608695652,6,13,27,46,41,5,8,16,20,2,0.2,"[0, 20, 40]",0.0003,0.0015,0.0015,5
1128,0.008139999999999677,0.6875,2,6,8,16,15,1,8,16,20,2,0.2,"[0, 20, 40]",0.0003,0.002,0.001,1
1129,0.011029999999999892,0.5882352941176471,1,13,20,34,31,3,8,16,20,2,0.2,"[0, 20, 40]",0.0003,0.002,0.001,3
1130,0.016099999999999972,0.6304347826086957,1,19,26,46,41,5,8,16,20,2,0.2,"[0, 20, 40]",0.0003,0.002,0.001,5
1131,0.009159999999999694,0.625,3,4,9,16,15,1,8,16,20,2,0.2,"[0, 20, 40]",0.0003,0.002,0.0015,1
1132,0.01131999999999984,0.5,2,9,23,34,31,3,8,16,20,2,0.2,"[0, 20, 40]",0.0003,0.002,0.0015,3
1133,0.0178299999999998,0.5434782608695652,3,13,30,46,41,5,8,16,20,2,0.2,"[0, 20, 40]",0.0003,0.002,0.0015,5
1134,0.0030899999999999235,0.8,1,3,1,5,5,0,8,16,20,2,0.2,"[0, 20, 40]",0.0005,0.001,0.001,1
1135,0.008059999999999774,0.6666666666666666,3,7,8,18,17,1,8,16,20,2,0.2,"[0, 20, 40]",0.0005,0.001,0.001,3
1136,0.015149999999999922,0.696969696969697,8,12,13,33,32,1,8,16,20,2,0.2,"[0, 20, 40]",0.0005,0.001,0.001,5
1137,0.0023099999999999206,0.6,1,2,2,5,5,0,8,16,20,2,0.2,"[0, 20, 40]",0.0005,0.001,0.0015,1
1138,0.007769999999999704,0.5555555555555556,3,5,10,18,17,1,8,16,20,2,0.2,"[0, 20, 40]",0.0005,0.001,0.0015,3
1139,0.012359999999999849,0.5757575757575758,8,8,17,33,32,1,8,16,20,2,0.2,"[0, 20, 40]",0.0005,0.001,0.0015,5
1140,0.00291999999999981,0.8,0,3,2,5,5,0,8,16,20,2,0.2,"[0, 20, 40]",0.0005,0.0015,0.001,1
1141,0.008269999999999653,0.6666666666666666,1,7,10,18,17,1,8,16,20,2,0.2,"[0, 20, 40]",0.0005,0.0015,0.001,3
1142,0.016949999999999497,0.696969696969697,4,12,17,33,32,1,8,16,20,2,0.2,"[0, 20, 40]",0.0005,0.0015,0.001,5
1143,0.002139999999999807,0.6,0,2,3,5,5,0,8,16,20,2,0.2,"[0, 20, 40]",0.0005,0.0015,0.0015,1
1144,0.007979999999999581,0.5555555555555556,1,5,12,18,17,1,8,16,20,2,0.2,"[0, 20, 40]",0.0005,0.0015,0.0015,3
1145,0.014159999999999427,0.5757575757575758,4,8,21,33,32,1,8,16,20,2,0.2,"[0, 20, 40]",0.0005,0.0015,0.0015,5
1146,0.00291999999999981,0.8,0,3,2,5,5,0,8,16,20,2,0.2,"[0, 20, 40]",0.0005,0.002,0.001,1
1147,0.008769999999999653,0.6666666666666666,1,7,10,18,17,1,8,16,20,2,0.2,"[0, 20, 40]",0.0005,0.002,0.001,3
1148,0.017329999999999107,0.696969696969697,2,12,19,33,32,1,8,16,20,2,0.2,"[0, 20, 40]",0.0005,0.002,0.001,5
1149,0.002139999999999807,0.6,0,2,3,5,5,0,8,16,20,2,0.2,"[0, 20, 40]",0.0005,0.002,0.0015,1
1150,0.008479999999999582,0.5555555555555556,1,5,12,18,17,1,8,16,20,2,0.2,"[0, 20, 40]",0.0005,0.002,0.0015,3
1151,0.01453999999999903,0.5757575757575758,2,8,23,33,32,1,8,16,20,2,0.2,"[0, 20, 40]",0.0005,0.002,0.0015,5
1152,0.00553999999999817,0.36538461538461536,5,10,37,52,34,18,8,17,5,1,0.1,"[0, 20, 40]",0.0003,0.001,0.001,1
1153,-0.005420000000003601,0.2692307692307692,6,12,86,104,71,33,8,17,5,1,0.1,"[0, 20, 40]",0.0003,0.001,0.001,3
1154,-0.0100900000000047,0.23255813953488372,6,13,110,129,92,37,8,17,5,1,0.1,"[0, 20, 40]",0.0003,0.001,0.001,5
1155,-0.002680000000001951,0.25,5,4,43,52,34,18,8,17,5,1,0.1,"[0, 20, 40]",0.0003,0.001,0.0015,1
1156,-0.017630000000003886,0.19230769230769232,6,4,94,104,71,33,8,17,5,1,0.1,"[0, 20, 40]",0.0003,0.001,0.0015,3
1157,-0.02230000000000494,0.17054263565891473,7,4,118,129,92,37,8,17,5,1,0.1,"[0, 20, 40]",0.0003,0.001,0.0015,5
1158,0.004249999999997938,0.34615384615384615,0,11,41,52,34,18,8,17,5,1,0.1,"[0, 20, 40]",0.0003,0.0015,0.001,1
1159,-0.006640000000003928,0.25961538461538464,0,13,91,104,71,33,8,17,5,1,0.1,"[0, 20, 40]",0.0003,0.0015,0.001,3
1160,-0.011310000000005026,0.2248062015503876,0,14,115,129,92,37,8,17,5,1,0.1,"[0, 20, 40]",0.0003,0.0015,0.001,5
1161,-0.005490000000002035,0.21153846153846154,0,4,48,52,34,18,8,17,5,1,0.1,"[0, 20, 40]",0.0003,0.0015,0.0015,1
1162,-0.020370000000004062,0.17307692307692307,0,4,100,104,71,33,8,17,5,1,0.1,"[0, 20, 40]",0.0003,0.0015,0.0015,3
1163,-0.024940000000005236,0.15503875968992248,0,4,125,129,92,37,8,17,5,1,0.1,"[0, 20, 40]",0.0003,0.0015,0.0015,5
1164,0.004249999999997938,0.34615384615384615,0,11,41,52,34,18,8,17,5,1,0.1,"[0, 20, 40]",0.0003,0.002,0.001,1
1165,-0.006640000000003928,0.25961538461538464,0,13,91,104,71,33,8,17,5,1,0.1,"[0, 20, 40]",0.0003,0.002,0.001,3
1166,-0.011310000000005026,0.2248062015503876,0,14,115,129,92,37,8,17,5,1,0.1,"[0, 20, 40]",0.0003,0.002,0.001,5
1167,-0.005490000000002035,0.21153846153846154,0,4,48,52,34,18,8,17,5,1,0.1,"[0, 20, 40]",0.0003,0.002,0.0015,1
1168,-0.020370000000004062,0.17307692307692307,0,4,100,104,71,33,8,17,5,1,0.1,"[0, 20, 40]",0.0003,0.002,0.0015,3
1169,-0.024940000000005236,0.15503875968992248,0,4,125,129,92,37,8,17,5,1,0.1,"[0, 20, 40]",0.0003,0.002,0.0015,5
1170,0.0013499999999993404,0.46153846153846156,1,2,10,13,9,4,8,17,5,1,0.1,"[0, 20, 40]",0.0005,0.001,0.001,1
1171,0.003969999999997386,0.42857142857142855,5,7,37,49,34,15,8,17,5,1,0.1,"[0, 20, 40]",0.0005,0.001,0.001,3
1172,-0.0011900000000040652,0.36363636363636365,6,7,64,77,61,16,8,17,5,1,0.1,"[0, 20, 40]",0.0005,0.001,0.001,5
1173,-0.0031900000000008692,0.3076923076923077,1,0,12,13,9,4,8,17,5,1,0.1,"[0, 20, 40]",0.0005,0.001,0.0015,1
1174,-0.010280000000003262,0.2857142857142857,5,0,44,49,34,15,8,17,5,1,0.1,"[0, 20, 40]",0.0005,0.001,0.0015,3
1175,-0.015440000000004719,0.2727272727272727,6,0,71,77,61,16,8,17,5,1,0.1,"[0, 20, 40]",0.0005,0.001,0.0015,5
1176,0.0003799999999993149,0.38461538461538464,0,2,11,13,9,4,8,17,5,1,0.1,"[0, 20, 40]",0.0005,0.0015,0.001,1
1177,0.0023799999999972415,0.3877551020408163,1,7,41,49,34,15,8,17,5,1,0.1,"[0, 20, 40]",0.0005,0.0015,0.001,3
1178,-0.002480000000004353,0.33766233766233766,1,7,69,77,61,16,8,17,5,1,0.1,"[0, 20, 40]",0.0005,0.0015,0.001,5
1179,-0.004160000000000893,0.23076923076923078,0,0,13,13,9,4,8,17,5,1,0.1,"[0, 20, 40]",0.0005,0.0015,0.0015,1
1180,-0.011870000000003409,0.24489795918367346,1,0,48,49,34,15,8,17,5,1,0.1,"[0, 20, 40]",0.0005,0.0015,0.0015,3
1181,-0.016730000000005005,0.24675324675324675,1,0,76,77,61,16,8,17,5,1,0.1,"[0, 20, 40]",0.0005,0.0015,0.0015,5
1182,0.0003799999999993149,0.38461538461538464,0,2,11,13,9,4,8,17,5,1,0.1,"[0, 20, 40]",0.0005,0.002,0.001,1
1183,0.002639999999997225,0.3877551020408163,0,7,42,49,34,15,8,17,5,1,0.1,"[0, 20, 40]",0.0005,0.002,0.001,3
1184,-0.002220000000004369,0.33766233766233766,0,7,70,77,61,16,8,17,5,1,0.1,"[0, 20, 40]",0.0005,0.002,0.001,5
1185,-0.004160000000000893,0.23076923076923078,0,0,13,13,9,4,8,17,5,1,0.1,"[0, 20, 40]",0.0005,0.002,0.0015,1
1186,-0.011610000000003427,0.24489795918367346,0,0,49,49,34,15,8,17,5,1,0.1,"[0, 20, 40]",0.0005,0.002,0.0015,3
1187,-0.016470000000005026,0.24675324675324675,0,0,77,77,61,16,8,17,5,1,0.1,"[0, 20, 40]",0.0005,0.002,0.0015,5
1188,0.004139999999999343,0.38461538461538464,3,4,19,26,21,5,8,17,5,1,0.2,"[0, 20, 40]",0.0003,0.001,0.001,1
1189,-0.003540000000001452,0.29411764705882354,3,5,43,51,42,9,8,17,5,1,0.2,"[0, 20, 40]",0.0003,0.001,0.001,3
1190,-0.007530000000001445,0.234375,3,5,56,64,53,11,8,17,5,1,0.2,"[0, 20, 40]",0.0003,0.001,0.001,5
1191,0.0015399999999992956,0.3076923076923077,3,2,21,26,21,5,8,17,5,1,0.2,"[0, 20, 40]",0.0003,0.001,0.0015,1
1192,-0.0079200000000015,0.23529411764705882,3,2,46,51,42,9,8,17,5,1,0.2,"[0, 20, 40]",0.0003,0.001,0.0015,3
1193,-0.011910000000001508,0.1875,3,2,59,64,53,11,8,17,5,1,0.2,"[0, 20, 40]",0.0003,0.001,0.0015,5
1194,0.002789999999999272,0.34615384615384615,0,4,22,26,21,5,8,17,5,1,0.2,"[0, 20, 40]",0.0003,0.0015,0.001,1
1195,-0.0048900000000015225,0.27450980392156865,0,5,46,51,42,9,8,17,5,1,0.2,"[0, 20, 40]",0.0003,0.0015,0.001,3
1196,-0.008880000000001517,0.21875,0,5,59,64,53,11,8,17,5,1,0.2,"[0, 20, 40]",0.0003,0.0015,0.001,5
1197,0.00018999999999922443,0.2692307692307692,0,2,24,26,21,5,8,17,5,1,0.2,"[0, 20, 40]",0.0003,0.0015,0.0015,1
1198,-0.009270000000001574,0.21568627450980393,0,2,49,51,42,9,8,17,5,1,0.2,"[0, 20, 40]",0.0003,0.0015,0.0015,3
1199,-0.01326000000000158,0.171875,0,2,62,64,53,11,8,17,5,1,0.2,"[0, 20, 40]",0.0003,0.0015,0.0015,5
1200,0.002789999999999272,0.34615384615384615,0,4,22,26,21,5,8,17,5,1,0.2,"[0, 20, 40]",0.0003,0.002,0.001,1
1201,-0.0048900000000015225,0.27450980392156865,0,5,46,51,42,9,8,17,5,1,0.2,"[0, 20, 40]",0.0003,0.002,0.001,3
1202,-0.008880000000001517,0.21875,0,5,59,64,53,11,8,17,5,1,0.2,"[0, 20, 40]",0.0003,0.002,0.001,5
1203,0.00018999999999922443,0.2692307692307692,0,2,24,26,21,5,8,17,5,1,0.2,"[0, 20, 40]",0.0003,0.002,0.0015,1
1204,-0.009270000000001574,0.21568627450980393,0,2,49,51,42,9,8,17,5,1,0.2,"[0, 20, 40]",0.0003,0.002,0.0015,3
1205,-0.01326000000000158,0.171875,0,2,62,64,53,11,8,17,5,1,0.2,"[0, 20, 40]",0.0003,0.002,0.0015,5
1206,0.0016399999999996196,0.6666666666666666,0,1,5,6,5,1,8,17,5,1,0.2,"[0, 20, 40]",0.0005,0.001,0.001,1
1207,0.0001299999999985874,0.4074074074074074,2,3,22,27,22,5,8,17,5,1,0.2,"[0, 20, 40]",0.0005,0.001,0.001,3
1208,-0.004490000000002055,0.3023255813953488,2,3,38,43,38,5,8,17,5,1,0.2,"[0, 20, 40]",0.0005,0.001,0.001,5
1209,-0.0006400000000005502,0.5,0,0,6,6,5,1,8,17,5,1,0.2,"[0, 20, 40]",0.0005,0.001,0.0015,1
1210,-0.006210000000001751,0.2962962962962963,2,0,25,27,22,5,8,17,5,1,0.2,"[0, 20, 40]",0.0005,0.001,0.0015,3
1211,-0.010830000000002398,0.23255813953488372,2,0,41,43,38,5,8,17,5,1,0.2,"[0, 20, 40]",0.0005,0.001,0.0015,5
1212,0.0016399999999996196,0.6666666666666666,0,1,5,6,5,1,8,17,5,1,0.2,"[0, 20, 40]",0.0005,0.0015,0.001,1
1213,-0.0001500000000015259,0.37037037037037035,1,3,23,27,22,5,8,17,5,1,0.2,"[0, 20, 40]",0.0005,0.0015,0.001,3
1214,-0.004770000000002168,0.27906976744186046,1,3,39,43,38,5,8,17,5,1,0.2,"[0, 20, 40]",0.0005,0.0015,0.001,5
1215,-0.0006400000000005502,0.5,0,0,6,6,5,1,8,17,5,1,0.2,"[0, 20, 40]",0.0005,0.0015,0.0015,1
1216,-0.006490000000001864,0.25925925925925924,1,0,26,27,22,5,8,17,5,1,0.2,"[0, 20, 40]",0.0005,0.0015,0.0015,3
1217,-0.011110000000002512,0.20930232558139536,1,0,42,43,38,5,8,17,5,1,0.2,"[0, 20, 40]",0.0005,0.0015,0.0015,5
1218,0.0016399999999996196,0.6666666666666666,0,1,5,6,5,1,8,17,5,1,0.2,"[0, 20, 40]",0.0005,0.002,0.001,1
1219,0.00010999999999845788,0.37037037037037035,0,3,24,27,22,5,8,17,5,1,0.2,"[0, 20, 40]",0.0005,0.002,0.001,3
1220,-0.004510000000002185,0.27906976744186046,0,3,40,43,38,5,8,17,5,1,0.2,"[0, 20, 40]",0.0005,0.002,0.001,5
1221,-0.0006400000000005502,0.5,0,0,6,6,5,1,8,17,5,1,0.2,"[0, 20, 40]",0.0005,0.002,0.0015,1
1222,-0.006230000000001881,0.25925925925925924,0,0,27,27,22,5,8,17,5,1,0.2,"[0, 20, 40]",0.0005,0.002,0.0015,3
1223,-0.010850000000002528,0.20930232558139536,0,0,43,43,38,5,8,17,5,1,0.2,"[0, 20, 40]",0.0005,0.002,0.0015,5
1224,0.0006099999999986896,0.3076923076923077,3,5,31,39,29,10,8,17,5,2,0.1,"[0, 20, 40]",0.0003,0.001,0.001,1
1225,-0.010290000000003402,0.22988505747126436,4,8,75,87,68,19,8,17,5,2,0.1,"[0, 20, 40]",0.0003,0.001,0.001,3
1226,-0.013530000000004296,0.20754716981132076,4,9,93,106,85,21,8,17,5,2,0.1,"[0, 20, 40]",0.0003,0.001,0.001,5
1227,-0.001150000000001351,0.2564102564102564,3,3,33,39,29,10,8,17,5,2,0.1,"[0, 20, 40]",0.0003,0.001,0.0015,1
1228,-0.015540000000003587,0.1839080459770115,4,4,79,87,68,19,8,17,5,2,0.1,"[0, 20, 40]",0.0003,0.001,0.0015,3
1229,-0.018780000000004477,0.16981132075471697,5,4,97,106,85,21,8,17,5,2,0.1,"[0, 20, 40]",0.0003,0.001,0.0015,5
1230,-0.0011800000000013774,0.28205128205128205,0,5,34,39,29,10,8,17,5,2,0.1,"[0, 20, 40]",0.0003,0.0015,0.001,1
1231,-0.012010000000003566,0.21839080459770116,0,8,79,87,68,19,8,17,5,2,0.1,"[0, 20, 40]",0.0003,0.0015,0.001,3
1232,-0.01525000000000446,0.19811320754716982,0,9,97,106,85,21,8,17,5,2,0.1,"[0, 20, 40]",0.0003,0.0015,0.001,5
1233,-0.002940000000001418,0.23076923076923078,0,3,36,39,29,10,8,17,5,2,0.1,"[0, 20, 40]",0.0003,0.0015,0.0015,1
1234,-0.017260000000003748,0.1724137931034483,0,4,83,87,68,19,8,17,5,2,0.1,"[0, 20, 40]",0.0003,0.0015,0.0015,3
1235,-0.020400000000004758,0.16037735849056603,0,4,102,106,85,21,8,17,5,2,0.1,"[0, 20, 40]",0.0003,0.0015,0.0015,5
1236,-0.0011800000000013774,0.28205128205128205,0,5,34,39,29,10,8,17,5,2,0.1,"[0, 20, 40]",0.0003,0.002,0.001,1
1237,-0.012010000000003566,0.21839080459770116,0,8,79,87,68,19,8,17,5,2,0.1,"[0, 20, 40]",0.0003,0.002,0.001,3
1238,-0.01525000000000446,0.19811320754716982,0,9,97,106,85,21,8,17,5,2,0.1,"[0, 20, 40]",0.0003,0.002,0.001,5
1239,-0.002940000000001418,0.23076923076923078,0,3,36,39,29,10,8,17,5,2,0.1,"[0, 20, 40]",0.0003,0.002,0.0015,1
1240,-0.017260000000003748,0.1724137931034483,0,4,83,87,68,19,8,17,5,2,0.1,"[0, 20, 40]",0.0003,0.002,0.0015,3
1241,-0.020400000000004758,0.16037735849056603,0,4,102,106,85,21,8,17,5,2,0.1,"[0, 20, 40]",0.0003,0.002,0.0015,5
1242,0.0014199999999995546,0.42857142857142855,1,2,11,14,11,3,8,17,5,2,0.1,"[0, 20, 40]",0.0005,0.001,0.001,1
1243,0.002879999999998192,0.4146341463414634,3,7,31,41,35,6,8,17,5,2,0.1,"[0, 20, 40]",0.0005,0.001,0.001,3
1244,-0.0007600000000024925,0.36507936507936506,4,7,52,63,57,6,8,17,5,2,0.1,"[0, 20, 40]",0.0005,0.001,0.001,5
1245,-0.003120000000000655,0.2857142857142857,1,0,13,14,11,3,8,17,5,2,0.1,"[0, 20, 40]",0.0005,0.001,0.0015,1
1246,-0.01148000000000251,0.24390243902439024,3,0,38,41,35,6,8,17,5,2,0.1,"[0, 20, 40]",0.0005,0.001,0.0015,3
1247,-0.015120000000003188,0.25396825396825395,4,0,59,63,57,6,8,17,5,2,0.1,"[0, 20, 40]",0.0005,0.001,0.0015,5
1248,0.00044999999999952944,0.35714285714285715,0,2,12,14,11,3,8,17,5,2,0.1,"[0, 20, 40]",0.0005,0.0015,0.001,1
1249,0.0012699999999979722,0.36585365853658536,0,7,34,41,35,6,8,17,5,2,0.1,"[0, 20, 40]",0.0005,0.0015,0.001,3
1250,-0.0020700000000028547,0.3333333333333333,0,7,56,63,57,6,8,17,5,2,0.1,"[0, 20, 40]",0.0005,0.0015,0.001,5
1251,-0.004090000000000678,0.21428571428571427,0,0,14,14,11,3,8,17,5,2,0.1,"[0, 20, 40]",0.0005,0.0015,0.0015,1
1252,-0.013090000000002735,0.1951219512195122,0,0,41,41,35,6,8,17,5,2,0.1,"[0, 20, 40]",0.0005,0.0015,0.0015,3
1253,-0.016430000000003553,0.2222222222222222,0,0,63,63,57,6,8,17,5,2,0.1,"[0, 20, 40]",0.0005,0.0015,0.0015,5
1254,0.00044999999999952944,0.35714285714285715,0,2,12,14,11,3,8,17,5,2,0.1,"[0, 20, 40]",0.0005,0.002,0.001,1
1255,0.0012699999999979722,0.36585365853658536,0,7,34,41,35,6,8,17,5,2,0.1,"[0, 20, 40]",0.0005,0.002,0.001,3
1256,-0.0020700000000028547,0.3333333333333333,0,7,56,63,57,6,8,17,5,2,0.1,"[0, 20, 40]",0.0005,0.002,0.001,5
1257,-0.004090000000000678,0.21428571428571427,0,0,14,14,11,3,8,17,5,2,0.1,"[0, 20, 40]",0.0005,0.002,0.0015,1
1258,-0.013090000000002735,0.1951219512195122,0,0,41,41,35,6,8,17,5,2,0.1,"[0, 20, 40]",0.0005,0.002,0.0015,3
1259,-0.016430000000003553,0.2222222222222222,0,0,63,63,57,6,8,17,5,2,0.1,"[0, 20, 40]",0.0005,0.002,0.0015,5
1260,0.0014299999999994868,0.4,3,2,15,20,19,1,8,17,5,2,0.2,"[0, 20, 40]",0.0003,0.001,0.001,1
1261,-0.004480000000001564,0.29545454545454547,3,4,37,44,40,4,8,17,5,2,0.2,"[0, 20, 40]",0.0003,0.001,0.001,3
1262,-0.006920000000001733,0.24561403508771928,3,5,49,57,51,6,8,17,5,2,0.2,"[0, 20, 40]",0.0003,0.001,0.001,5
1263,0.002429999999999485,0.4,3,2,15,20,19,1,8,17,5,2,0.2,"[0, 20, 40]",0.0003,0.001,0.0015,1
1264,-0.004760000000001569,0.2727272727272727,3,3,38,44,40,4,8,17,5,2,0.2,"[0, 20, 40]",0.0003,0.001,0.0015,3
1265,-0.0072000000000017415,0.22807017543859648,4,3,50,57,51,6,8,17,5,2,0.2,"[0, 20, 40]",0.0003,0.001,0.0015,5
1266,-0.0003600000000005799,0.35,0,2,18,20,19,1,8,17,5,2,0.2,"[0, 20, 40]",0.0003,0.0015,0.001,1
1267,-0.00627000000000163,0.2727272727272727,0,4,40,44,40,4,8,17,5,2,0.2,"[0, 20, 40]",0.0003,0.0015,0.001,3
1268,-0.008710000000001801,0.22807017543859648,0,5,52,57,51,6,8,17,5,2,0.2,"[0, 20, 40]",0.0003,0.0015,0.001,5
1269,0.0006399999999994185,0.35,0,2,18,20,19,1,8,17,5,2,0.2,"[0, 20, 40]",0.0003,0.0015,0.0015,1
1270,-0.006550000000001634,0.25,0,3,41,44,40,4,8,17,5,2,0.2,"[0, 20, 40]",0.0003,0.0015,0.0015,3
1271,-0.00889000000000193,0.21052631578947367,0,3,54,57,51,6,8,17,5,2,0.2,"[0, 20, 40]",0.0003,0.0015,0.0015,5
1272,-0.0003600000000005799,0.35,0,2,18,20,19,1,8,17,5,2,0.2,"[0, 20, 40]",0.0003,0.002,0.001,1
1273,-0.00627000000000163,0.2727272727272727,0,4,40,44,40,4,8,17,5,2,0.2,"[0, 20, 40]",0.0003,0.002,0.001,3
1274,-0.008710000000001801,0.22807017543859648,0,5,52,57,51,6,8,17,5,2,0.2,"[0, 20, 40]",0.0003,0.002,0.001,5
1275,0.0006399999999994185,0.35,0,2,18,20,19,1,8,17,5,2,0.2,"[0, 20, 40]",0.0003,0.002,0.0015,1
1276,-0.006550000000001634,0.25,0,3,41,44,40,4,8,17,5,2,0.2,"[0, 20, 40]",0.0003,0.002,0.0015,3
1277,-0.00889000000000193,0.21052631578947367,0,3,54,57,51,6,8,17,5,2,0.2,"[0, 20, 40]",0.0003,0.002,0.0015,5
1278,-0.0002700000000002365,0.3333333333333333,0,1,5,6,6,0,8,17,5,2,0.2,"[0, 20, 40]",0.0005,0.001,0.001,1
1279,0.0009699999999992254,0.42857142857142855,2,4,15,21,20,1,8,17,5,2,0.2,"[0, 20, 40]",0.0005,0.001,0.001,3
1280,-0.0014000000000012232,0.35135135135135137,3,4,30,37,36,1,8,17,5,2,0.2,"[0, 20, 40]",0.0005,0.001,0.001,5
1281,-0.002550000000000407,0.16666666666666666,0,0,6,6,6,0,8,17,5,2,0.2,"[0, 20, 40]",0.0005,0.001,0.0015,1
1282,-0.0072800000000010825,0.23809523809523808,2,0,19,21,20,1,8,17,5,2,0.2,"[0, 20, 40]",0.0005,0.001,0.0015,3
1283,-0.00965000000000153,0.24324324324324326,3,0,34,37,36,1,8,17,5,2,0.2,"[0, 20, 40]",0.0005,0.001,0.0015,5
1284,-0.0002700000000002365,0.3333333333333333,0,1,5,6,6,0,8,17,5,2,0.2,"[0, 20, 40]",0.0005,0.0015,0.001,1
1285,0.00032999999999903116,0.38095238095238093,0,4,17,21,20,1,8,17,5,2,0.2,"[0, 20, 40]",0.0005,0.0015,0.001,3
1286,-0.0017400000000015602,0.32432432432432434,0,4,33,37,36,1,8,17,5,2,0.2,"[0, 20, 40]",0.0005,0.0015,0.001,5
1287,-0.002550000000000407,0.16666666666666666,0,0,6,6,6,0,8,17,5,2,0.2,"[0, 20, 40]",0.0005,0.0015,0.0015,1
1288,-0.007920000000001277,0.19047619047619047,0,0,21,21,20,1,8,17,5,2,0.2,"[0, 20, 40]",0.0005,0.0015,0.0015,3
1289,-0.009990000000001869,0.21621621621621623,0,0,37,37,36,1,8,17,5,2,0.2,"[0, 20, 40]",0.0005,0.0015,0.0015,5
1290,-0.0002700000000002365,0.3333333333333333,0,1,5,6,6,0,8,17,5,2,0.2,"[0, 20, 40]",0.0005,0.002,0.001,1
1291,0.00032999999999903116,0.38095238095238093,0,4,17,21,20,1,8,17,5,2,0.2,"[0, 20, 40]",0.0005,0.002,0.001,3
1292,-0.0017400000000015602,0.32432432432432434,0,4,33,37,36,1,8,17,5,2,0.2,"[0, 20, 40]",0.0005,0.002,0.001,5
1293,-0.002550000000000407,0.16666666666666666,0,0,6,6,6,0,8,17,5,2,0.2,"[0, 20, 40]",0.0005,0.002,0.0015,1
1294,-0.007920000000001277,0.19047619047619047,0,0,21,21,20,1,8,17,5,2,0.2,"[0, 20, 40]",0.0005,0.002,0.0015,3
1295,-0.009990000000001869,0.21621621621621623,0,0,37,37,36,1,8,17,5,2,0.2,"[0, 20, 40]",0.0005,0.002,0.0015,5
1296,0.012619999999998466,0.5769230769230769,10,12,30,52,34,18,8,17,10,1,0.1,"[0, 20, 40]",0.0003,0.001,0.001,1
1297,0.009259999999998032,0.44761904761904764,18,19,68,105,72,33,8,17,10,1,0.1,"[0, 20, 40]",0.0003,0.001,0.001,3
1298,0.014139999999997339,0.4580152671755725,21,23,87,131,94,37,8,17,10,1,0.1,"[0, 20, 40]",0.0003,0.001,0.001,5
1299,0.005629999999998588,0.4423076923076923,10,5,37,52,34,18,8,17,10,1,0.1,"[0, 20, 40]",0.0003,0.001,0.0015,1
1300,-0.0011600000000019945,0.3523809523809524,18,9,78,105,72,33,8,17,10,1,0.1,"[0, 20, 40]",0.0003,0.001,0.0015,3
1301,0.0008199999999972406,0.366412213740458,22,10,99,131,94,37,8,17,10,1,0.1,"[0, 20, 40]",0.0003,0.001,0.0015,5
1302,0.014069999999998195,0.5769230769230769,4,14,34,52,34,18,8,17,10,1,0.1,"[0, 20, 40]",0.0003,0.0015,0.001,1
1303,0.009849999999997463,0.44761904761904764,4,21,80,105,72,33,8,17,10,1,0.1,"[0, 20, 40]",0.0003,0.0015,0.001,3
1304,0.013289999999996327,0.45038167938931295,4,25,102,131,94,37,8,17,10,1,0.1,"[0, 20, 40]",0.0003,0.0015,0.001,5
1305,0.0068999999999981914,0.4230769230769231,5,5,42,52,34,18,8,17,10,1,0.1,"[0, 20, 40]",0.0003,0.0015,0.0015,1
1306,-0.0007500000000026869,0.34285714285714286,5,9,91,105,72,33,8,17,10,1,0.1,"[0, 20, 40]",0.0003,0.0015,0.0015,3
1307,4.999999999591388e-05,0.3511450381679389,5,10,116,131,94,37,8,17,10,1,0.1,"[0, 20, 40]",0.0003,0.0015,0.0015,5
1308,0.013739999999998032,0.5769230769230769,2,14,36,52,34,18,8,17,10,1,0.1,"[0, 20, 40]",0.0003,0.002,0.001,1
1309,0.009519999999997301,0.44761904761904764,2,21,82,105,72,33,8,17,10,1,0.1,"[0, 20, 40]",0.0003,0.002,0.001,3
1310,0.012959999999996167,0.45038167938931295,2,25,104,131,94,37,8,17,10,1,0.1,"[0, 20, 40]",0.0003,0.002,0.001,5
1311,0.00689999999999803,0.4230769230769231,2,5,45,52,34,18,8,17,10,1,0.1,"[0, 20, 40]",0.0003,0.002,0.0015,1
1312,-0.0007500000000028518,0.34285714285714286,2,9,94,105,72,33,8,17,10,1,0.1,"[0, 20, 40]",0.0003,0.002,0.0015,3
1313,4.999999999574323e-05,0.3511450381679389,2,10,119,131,94,37,8,17,10,1,0.1,"[0, 20, 40]",0.0003,0.002,0.0015,5
1314,0.00533999999999983,0.6923076923076923,4,4,5,13,9,4,8,17,10,1,0.1,"[0, 20, 40]",0.0005,0.001,0.001,1
1315,0.014329999999999166,0.58,14,11,25,50,35,15,8,17,10,1,0.1,"[0, 20, 40]",0.0005,0.001,0.001,3
1316,0.019529999999997737,0.5443037974683544,21,14,44,79,63,16,8,17,10,1,0.1,"[0, 20, 40]",0.0005,0.001,0.001,5
1317,0.001079999999999845,0.46153846153846156,4,1,8,13,9,4,8,17,10,1,0.1,"[0, 20, 40]",0.0005,0.001,0.0015,1
1318,0.007559999999999059,0.46,14,5,31,50,35,15,8,17,10,1,0.1,"[0, 20, 40]",0.0005,0.001,0.0015,3
1319,0.012319999999997392,0.45569620253164556,21,7,51,79,63,16,8,17,10,1,0.1,"[0, 20, 40]",0.0005,0.001,0.0015,5
1320,0.003749999999999351,0.5384615384615384,1,4,8,13,9,4,8,17,10,1,0.1,"[0, 20, 40]",0.0005,0.0015,0.001,1
1321,0.015919999999998536,0.54,7,11,32,50,35,15,8,17,10,1,0.1,"[0, 20, 40]",0.0005,0.0015,0.001,3
1322,0.022189999999996338,0.5189873417721519,9,14,56,79,63,16,8,17,10,1,0.1,"[0, 20, 40]",0.0005,0.0015,0.001,5
1323,-0.0005100000000006332,0.3076923076923077,1,1,11,13,9,4,8,17,10,1,0.1,"[0, 20, 40]",0.0005,0.0015,0.0015,1
1324,0.009149999999998427,0.42,7,5,38,50,35,15,8,17,10,1,0.1,"[0, 20, 40]",0.0005,0.0015,0.0015,3
1325,0.014979999999996012,0.43037974683544306,9,7,63,79,63,16,8,17,10,1,0.1,"[0, 20, 40]",0.0005,0.0015,0.0015,5
1326,0.0042499999999993515,0.5384615384615384,1,4,8,13,9,4,8,17,10,1,0.1,"[0, 20, 40]",0.0005,0.002,0.001,1
1327,0.014389999999998009,0.52,3,11,36,50,35,15,8,17,10,1,0.1,"[0, 20, 40]",0.0005,0.002,0.001,3
1328,0.020699999999995757,0.5063291139240507,4,14,61,79,63,16,8,17,10,1,0.1,"[0, 20, 40]",0.0005,0.002,0.001,5
1329,-1.00000000006332e-05,0.3076923076923077,1,1,11,13,9,4,8,17,10,1,0.1,"[0, 20, 40]",0.0005,0.002,0.0015,1
1330,0.007619999999997905,0.4,3,5,42,50,35,15,8,17,10,1,0.1,"[0, 20, 40]",0.0005,0.002,0.0015,3
1331,0.013489999999995403,0.4177215189873418,4,7,68,79,63,16,8,17,10,1,0.1,"[0, 20, 40]",0.0005,0.002,0.0015,5
1332,0.007219999999999979,0.6153846153846154,8,5,13,26,21,5,8,17,10,1,0.2,"[0, 20, 40]",0.0003,0.001,0.001,1
1333,0.0033999999999998177,0.43137254901960786,10,8,33,51,42,9,8,17,10,1,0.2,"[0, 20, 40]",0.0003,0.001,0.001,3
1334,0.0075999999999996045,0.46153846153846156,12,11,42,65,54,11,8,17,10,1,0.2,"[0, 20, 40]",0.0003,0.001,0.001,5
1335,0.004450000000000039,0.5,8,2,16,26,21,5,8,17,10,1,0.2,"[0, 20, 40]",0.0003,0.001,0.0015,1
1336,-0.0005300000000001704,0.35294117647058826,10,4,37,51,42,9,8,17,10,1,0.2,"[0, 20, 40]",0.0003,0.001,0.0015,3
1337,0.0007699999999995411,0.36923076923076925,12,5,48,65,54,11,8,17,10,1,0.2,"[0, 20, 40]",0.0003,0.001,0.0015,5
1338,0.008169999999999709,0.6153846153846154,3,6,17,26,21,5,8,17,10,1,0.2,"[0, 20, 40]",0.0003,0.0015,0.001,1
1339,0.0038299999999994744,0.43137254901960786,3,9,39,51,42,9,8,17,10,1,0.2,"[0, 20, 40]",0.0003,0.0015,0.001,3
1340,0.006549999999998892,0.4461538461538462,3,12,50,65,54,11,8,17,10,1,0.2,"[0, 20, 40]",0.0003,0.0015,0.001,5
1341,0.004719999999999647,0.46153846153846156,3,2,21,26,21,5,8,17,10,1,0.2,"[0, 20, 40]",0.0003,0.0015,0.0015,1
1342,-0.0007800000000006386,0.3333333333333333,3,4,44,51,42,9,8,17,10,1,0.2,"[0, 20, 40]",0.0003,0.0015,0.0015,3
1343,-0.0009600000000012943,0.3384615384615385,3,5,57,65,54,11,8,17,10,1,0.2,"[0, 20, 40]",0.0003,0.0015,0.0015,5
1344,0.0073399999999995465,0.6153846153846154,1,6,19,26,21,5,8,17,10,1,0.2,"[0, 20, 40]",0.0003,0.002,0.001,1
1345,0.0029999999999993135,0.43137254901960786,1,9,41,51,42,9,8,17,10,1,0.2,"[0, 20, 40]",0.0003,0.002,0.001,3
1346,0.005719999999998728,0.4461538461538462,1,12,52,65,54,11,8,17,10,1,0.2,"[0, 20, 40]",0.0003,0.002,0.001,5
1347,0.003889999999999483,0.46153846153846156,1,2,23,26,21,5,8,17,10,1,0.2,"[0, 20, 40]",0.0003,0.002,0.0015,1
1348,-0.0016100000000008013,0.3333333333333333,1,4,46,51,42,9,8,17,10,1,0.2,"[0, 20, 40]",0.0003,0.002,0.0015,3
1349,-0.0017900000000014567,0.3384615384615385,1,5,59,65,54,11,8,17,10,1,0.2,"[0, 20, 40]",0.0003,0.002,0.0015,5
1350,0.0018,0.6666666666666666,2,1,3,6,5,1,8,17,10,1,0.2,"[0, 20, 40]",0.0005,0.001,0.001,1
1351,0.0057399999999998095,0.5555555555555556,7,4,16,27,22,5,8,17,10,1,0.2,"[0, 20, 40]",0.0005,0.001,0.001,3
1352,0.008389999999998916,0.5227272727272727,9,7,28,44,39,5,8,17,10,1,0.2,"[0, 20, 40]",0.0005,0.001,0.001,5
1353,0.0023,0.6666666666666666,2,1,3,6,5,1,8,17,10,1,0.2,"[0, 20, 40]",0.0005,0.001,0.0015,1
1354,0.005239999999999695,0.5185185185185185,7,3,17,27,22,5,8,17,10,1,0.2,"[0, 20, 40]",0.0005,0.001,0.0015,3
1355,0.007449999999998583,0.4772727272727273,9,5,30,44,39,5,8,17,10,1,0.2,"[0, 20, 40]",0.0005,0.001,0.0015,5
1356,0.0016799999999998249,0.5,1,1,4,6,5,1,8,17,10,1,0.2,"[0, 20, 40]",0.0005,0.0015,0.001,1
1357,0.006559999999999577,0.5185185185185185,3,4,20,27,22,5,8,17,10,1,0.2,"[0, 20, 40]",0.0005,0.0015,0.001,3
1358,0.00864999999999857,0.5,3,7,34,44,39,5,8,17,10,1,0.2,"[0, 20, 40]",0.0005,0.0015,0.001,5
1359,0.002179999999999825,0.5,1,1,4,6,5,1,8,17,10,1,0.2,"[0, 20, 40]",0.0005,0.0015,0.0015,1
1360,0.006059999999999463,0.48148148148148145,3,3,21,27,22,5,8,17,10,1,0.2,"[0, 20, 40]",0.0005,0.0015,0.0015,3
1361,0.007709999999998236,0.45454545454545453,3,5,36,44,39,5,8,17,10,1,0.2,"[0, 20, 40]",0.0005,0.0015,0.0015,5
1362,0.002179999999999825,0.5,1,1,4,6,5,1,8,17,10,1,0.2,"[0, 20, 40]",0.0005,0.002,0.001,1
1363,0.005409999999999315,0.48148148148148145,1,4,22,27,22,5,8,17,10,1,0.2,"[0, 20, 40]",0.0005,0.002,0.001,3
1364,0.007499999999998311,0.4772727272727273,1,7,36,44,39,5,8,17,10,1,0.2,"[0, 20, 40]",0.0005,0.002,0.001,5
1365,0.002679999999999825,0.5,1,1,4,6,5,1,8,17,10,1,0.2,"[0, 20, 40]",0.0005,0.002,0.0015,1
1366,0.004909999999999202,0.4444444444444444,1,3,23,27,22,5,8,17,10,1,0.2,"[0, 20, 40]",0.0005,0.002,0.0015,3
1367,0.006559999999997978,0.4318181818181818,1,5,38,44,39,5,8,17,10,1,0.2,"[0, 20, 40]",0.0005,0.002,0.0015,5
1368,0.004949999999998696,0.48717948717948717,5,7,27,39,29,10,8,17,10,2,0.1,"[0, 20, 40]",0.0003,0.001,0.001,1
1369,0.004079999999997564,0.4090909090909091,12,15,61,88,69,19,8,17,10,2,0.1,"[0, 20, 40]",0.0003,0.001,0.001,3
1370,0.008809999999997136,0.4351851851851852,15,19,74,108,87,21,8,17,10,2,0.1,"[0, 20, 40]",0.0003,0.001,0.001,5
1371,0.0023499999999988717,0.41025641025641024,5,4,30,39,29,10,8,17,10,2,0.1,"[0, 20, 40]",0.0003,0.001,0.0015,1
1372,0.0002999999999976729,0.3522727272727273,12,10,66,88,69,19,8,17,10,2,0.1,"[0, 20, 40]",0.0003,0.001,0.0015,3
1373,0.0021299999999971706,0.37037037037037035,16,11,81,108,87,21,8,17,10,2,0.1,"[0, 20, 40]",0.0003,0.001,0.0015,5
1374,0.004959999999998651,0.48717948717948717,2,8,29,39,29,10,8,17,10,2,0.1,"[0, 20, 40]",0.0003,0.0015,0.001,1
1375,0.0035999999999973124,0.4090909090909091,2,16,70,88,69,19,8,17,10,2,0.1,"[0, 20, 40]",0.0003,0.0015,0.001,3
1376,0.006889999999996445,0.42592592592592593,2,20,86,108,87,21,8,17,10,2,0.1,"[0, 20, 40]",0.0003,0.0015,0.001,5
1377,0.001679999999998702,0.38461538461538464,2,4,33,39,29,10,8,17,10,2,0.1,"[0, 20, 40]",0.0003,0.0015,0.0015,1
1378,-0.0008600000000027027,0.3409090909090909,2,10,76,88,69,19,8,17,10,2,0.1,"[0, 20, 40]",0.0003,0.0015,0.0015,3
1379,-0.00021000000000383692,0.35185185185185186,2,11,95,108,87,21,8,17,10,2,0.1,"[0, 20, 40]",0.0003,0.0015,0.0015,5
1380,0.005399999999998759,0.48717948717948717,1,8,30,39,29,10,8,17,10,2,0.1,"[0, 20, 40]",0.0003,0.002,0.001,1
1381,0.004039999999997421,0.4090909090909091,1,16,71,88,69,19,8,17,10,2,0.1,"[0, 20, 40]",0.0003,0.002,0.001,3
1382,0.007329999999996554,0.42592592592592593,1,20,87,108,87,21,8,17,10,2,0.1,"[0, 20, 40]",0.0003,0.002,0.001,5
1383,0.00211999999999881,0.38461538461538464,1,4,34,39,29,10,8,17,10,2,0.1,"[0, 20, 40]",0.0003,0.002,0.0015,1
1384,-0.00042000000000259473,0.3409090909090909,1,10,77,88,69,19,8,17,10,2,0.1,"[0, 20, 40]",0.0003,0.002,0.0015,3
1385,0.00022999999999627092,0.35185185185185186,1,11,96,108,87,21,8,17,10,2,0.1,"[0, 20, 40]",0.0003,0.002,0.0015,5
1386,0.0037099999999998983,0.5714285714285714,4,3,7,14,11,3,8,17,10,2,0.1,"[0, 20, 40]",0.0005,0.001,0.001,1
1387,0.012879999999999281,0.5952380952380952,11,11,20,42,36,6,8,17,10,2,0.1,"[0, 20, 40]",0.0005,0.001,0.001,3
1388,0.018339999999998243,0.5692307692307692,17,14,34,65,59,6,8,17,10,2,0.1,"[0, 20, 40]",0.0005,0.001,0.001,5
1389,0.00032999999999979465,0.42857142857142855,4,1,9,14,11,3,8,17,10,2,0.1,"[0, 20, 40]",0.0005,0.001,0.0015,1
1390,0.0073199999999990495,0.47619047619047616,11,6,25,42,36,6,8,17,10,2,0.1,"[0, 20, 40]",0.0005,0.001,0.0015,3
1391,0.012339999999997776,0.47692307692307695,17,8,40,65,59,6,8,17,10,2,0.1,"[0, 20, 40]",0.0005,0.001,0.0015,5
1392,0.0021199999999994205,0.42857142857142855,1,3,10,14,11,3,8,17,10,2,0.1,"[0, 20, 40]",0.0005,0.0015,0.001,1
1393,0.012969999999998651,0.5476190476190477,4,11,27,42,36,6,8,17,10,2,0.1,"[0, 20, 40]",0.0005,0.0015,0.001,3
1394,0.019579999999997048,0.5384615384615384,6,14,45,65,59,6,8,17,10,2,0.1,"[0, 20, 40]",0.0005,0.0015,0.001,5
1395,-0.0012600000000006838,0.2857142857142857,1,1,12,14,11,3,8,17,10,2,0.1,"[0, 20, 40]",0.0005,0.0015,0.0015,1
1396,0.007409999999998425,0.42857142857142855,4,6,32,42,36,6,8,17,10,2,0.1,"[0, 20, 40]",0.0005,0.0015,0.0015,3
1397,0.013579999999996576,0.4461538461538462,6,8,51,65,59,6,8,17,10,2,0.1,"[0, 20, 40]",0.0005,0.0015,0.0015,5
1398,0.0026199999999994205,0.42857142857142855,1,3,10,14,11,3,8,17,10,2,0.1,"[0, 20, 40]",0.0005,0.002,0.001,1
1399,0.012589999999998382,0.5476190476190477,2,11,29,42,36,6,8,17,10,2,0.1,"[0, 20, 40]",0.0005,0.002,0.001,3
1400,0.01923999999999671,0.5384615384615384,3,14,48,65,59,6,8,17,10,2,0.1,"[0, 20, 40]",0.0005,0.002,0.001,5
1401,-0.0007600000000006837,0.2857142857142857,1,1,12,14,11,3,8,17,10,2,0.1,"[0, 20, 40]",0.0005,0.002,0.0015,1
1402,0.007029999999998157,0.42857142857142855,2,6,34,42,36,6,8,17,10,2,0.1,"[0, 20, 40]",0.0005,0.002,0.0015,3
1403,0.01323999999999624,0.4461538461538462,3,8,54,65,59,6,8,17,10,2,0.1,"[0, 20, 40]",0.0005,0.002,0.0015,5
1404,0.0036400000000000837,0.6,4,4,12,20,19,1,8,17,10,2,0.2,"[0, 20, 40]",0.0003,0.001,0.001,1
1405,0.0016699999999997442,0.4318181818181818,6,8,30,44,40,4,8,17,10,2,0.2,"[0, 20, 40]",0.0003,0.001,0.001,3
1406,0.006109999999999324,0.4827586206896552,7,12,39,58,52,6,8,17,10,2,0.2,"[0, 20, 40]",0.0003,0.001,0.001,5
1407,0.00096000000000018,0.5,4,2,14,20,19,1,8,17,10,2,0.2,"[0, 20, 40]",0.0003,0.001,0.0015,1
1408,-0.0016700000000002078,0.36363636363636365,6,5,33,44,40,4,8,17,10,2,0.2,"[0, 20, 40]",0.0003,0.001,0.0015,3
1409,-0.0001300000000006991,0.39655172413793105,8,6,44,58,52,6,8,17,10,2,0.2,"[0, 20, 40]",0.0003,0.001,0.0015,5
1410,0.003150000000000039,0.6,1,5,14,20,19,1,8,17,10,2,0.2,"[0, 20, 40]",0.0003,0.0015,0.001,1
1411,0.001309999999999664,0.4318181818181818,1,9,34,44,40,4,8,17,10,2,0.2,"[0, 20, 40]",0.0003,0.0015,0.001,3
1412,0.004489999999999092,0.46551724137931033,1,13,44,58,52,6,8,17,10,2,0.2,"[0, 20, 40]",0.0003,0.0015,0.001,5
1413,-0.00020999999999998887,0.45,1,2,17,20,19,1,8,17,10,2,0.2,"[0, 20, 40]",0.0003,0.0015,0.0015,1
1414,-0.0027100000000004104,0.3409090909090909,1,5,38,44,40,4,8,17,10,2,0.2,"[0, 20, 40]",0.0003,0.0015,0.0015,3
1415,-0.0021700000000012347,0.3620689655172414,1,6,51,58,52,6,8,17,10,2,0.2,"[0, 20, 40]",0.0003,0.0015,0.0015,5
1416,0.003090000000000147,0.6,0,5,15,20,19,1,8,17,10,2,0.2,"[0, 20, 40]",0.0003,0.002,0.001,1
1417,0.001249999999999772,0.4318181818181818,0,9,35,44,40,4,8,17,10,2,0.2,"[0, 20, 40]",0.0003,0.002,0.001,3
1418,0.0044299999999992,0.46551724137931033,0,13,45,58,52,6,8,17,10,2,0.2,"[0, 20, 40]",0.0003,0.002,0.001,5
1419,-0.000269999999999881,0.45,0,2,18,20,19,1,8,17,10,2,0.2,"[0, 20, 40]",0.0003,0.002,0.0015,1
1420,-0.0027700000000003026,0.3409090909090909,0,5,39,44,40,4,8,17,10,2,0.2,"[0, 20, 40]",0.0003,0.002,0.0015,3
1421,-0.002230000000001127,0.3620689655172414,0,6,52,58,52,6,8,17,10,2,0.2,"[0, 20, 40]",0.0003,0.002,0.0015,5
1422,0.0004899999999999676,0.5,0,2,4,6,6,0,8,17,10,2,0.2,"[0, 20, 40]",0.0005,0.001,0.001,1
1423,0.0037299999999998736,0.5238095238095238,3,6,12,21,20,1,8,17,10,2,0.2,"[0, 20, 40]",0.0005,0.001,0.001,3
1424,0.007659999999999151,0.5263157894736842,7,9,22,38,37,1,8,17,10,2,0.2,"[0, 20, 40]",0.0005,0.001,0.001,5
1425,-0.0005900000000000575,0.3333333333333333,0,1,5,6,6,0,8,17,10,2,0.2,"[0, 20, 40]",0.0005,0.001,0.0015,1
1426,0.0002699999999996892,0.38095238095238093,3,3,15,21,20,1,8,17,10,2,0.2,"[0, 20, 40]",0.0005,0.001,0.0015,3
1427,0.003759999999998747,0.42105263157894735,7,5,26,38,37,1,8,17,10,2,0.2,"[0, 20, 40]",0.0005,0.001,0.0015,5
1428,0.0004899999999999676,0.5,0,2,4,6,6,0,8,17,10,2,0.2,"[0, 20, 40]",0.0005,0.0015,0.001,1
1429,0.004169999999999704,0.5238095238095238,1,6,14,21,20,1,8,17,10,2,0.2,"[0, 20, 40]",0.0005,0.0015,0.001,3
1430,0.00824999999999841,0.5263157894736842,1,9,28,38,37,1,8,17,10,2,0.2,"[0, 20, 40]",0.0005,0.0015,0.001,5
1431,-0.0005900000000000575,0.3333333333333333,0,1,5,6,6,0,8,17,10,2,0.2,"[0, 20, 40]",0.0005,0.0015,0.0015,1
1432,0.0007099999999995199,0.38095238095238093,1,3,17,21,20,1,8,17,10,2,0.2,"[0, 20, 40]",0.0005,0.0015,0.0015,3
1433,0.00434999999999801,0.42105263157894735,1,5,32,38,37,1,8,17,10,2,0.2,"[0, 20, 40]",0.0005,0.0015,0.0015,5
1434,0.0004899999999999676,0.5,0,2,4,6,6,0,8,17,10,2,0.2,"[0, 20, 40]",0.0005,0.002,0.001,1
1435,0.004669999999999705,0.5238095238095238,1,6,14,21,20,1,8,17,10,2,0.2,"[0, 20, 40]",0.0005,0.002,0.001,3
1436,0.008749999999998408,0.5263157894736842,1,9,28,38,37,1,8,17,10,2,0.2,"[0, 20, 40]",0.0005,0.002,0.001,5
1437,-0.0005900000000000575,0.3333333333333333,0,1,5,6,6,0,8,17,10,2,0.2,"[0, 20, 40]",0.0005,0.002,0.0015,1
1438,0.0012099999999995196,0.38095238095238093,1,3,17,21,20,1,8,17,10,2,0.2,"[0, 20, 40]",0.0005,0.002,0.0015,3
1439,0.0048499999999980095,0.42105263157894735,1,5,32,38,37,1,8,17,10,2,0.2,"[0, 20, 40]",0.0005,0.002,0.0015,5
1440,0.01718999999999869,0.64,13,15,22,50,32,18,8,17,15,1,0.1,"[0, 20, 40]",0.0003,0.001,0.001,1
1441,0.02535999999999697,0.5588235294117647,22,27,53,102,69,33,8,17,15,1,0.1,"[0, 20, 40]",0.0003,0.001,0.001,3
1442,0.03225999999999643,0.5511811023622047,27,31,69,127,90,37,8,17,15,1,0.1,"[0, 20, 40]",0.0003,0.001,0.001,5
1443,0.009269999999998656,0.52,14,6,30,50,32,18,8,17,15,1,0.1,"[0, 20, 40]",0.0003,0.001,0.0015,1
1444,0.012699999999996589,0.45098039215686275,23,13,66,102,69,33,8,17,15,1,0.1,"[0, 20, 40]",0.0003,0.001,0.0015,3
1445,0.01843999999999622,0.4566929133858268,29,15,83,127,90,37,8,17,15,1,0.1,"[0, 20, 40]",0.0003,0.001,0.0015,5
1446,0.01839999999999801,0.62,5,17,28,50,32,18,8,17,15,1,0.1,"[0, 20, 40]",0.0003,0.0015,0.001,1
1447,0.027089999999996037,0.5392156862745098,9,29,64,102,69,33,8,17,15,1,0.1,"[0, 20, 40]",0.0003,0.0015,0.001,3
1448,0.03200999999999531,0.5275590551181102,9,33,85,127,90,37,8,17,15,1,0.1,"[0, 20, 40]",0.0003,0.0015,0.001,5
1449,0.011479999999997867,0.5,7,6,37,50,32,18,8,17,15,1,0.1,"[0, 20, 40]",0.0003,0.0015,0.0015,1
1450,0.015429999999995546,0.43137254901960786,11,13,78,102,69,33,8,17,15,1,0.1,"[0, 20, 40]",0.0003,0.0015,0.0015,3
1451,0.019689999999995,0.4330708661417323,12,15,100,127,90,37,8,17,15,1,0.1,"[0, 20, 40]",0.0003,0.0015,0.0015,5
1452,0.01842999999999804,0.6,3,17,30,50,32,18,8,17,15,1,0.1,"[0, 20, 40]",0.0003,0.002,0.001,1
1453,0.028509999999996077,0.5294117647058824,6,29,67,102,69,33,8,17,15,1,0.1,"[0, 20, 40]",0.0003,0.002,0.001,3
1454,0.03342999999999536,0.5196850393700787,6,33,88,127,90,37,8,17,15,1,0.1,"[0, 20, 40]",0.0003,0.002,0.001,5
1455,0.011929999999998098,0.48,3,6,41,50,32,18,8,17,15,1,0.1,"[0, 20, 40]",0.0003,0.002,0.0015,1
1456,0.017269999999995792,0.4215686274509804,6,13,83,102,69,33,8,17,15,1,0.1,"[0, 20, 40]",0.0003,0.002,0.0015,3
1457,0.022029999999995237,0.4251968503937008,7,15,105,127,90,37,8,17,15,1,0.1,"[0, 20, 40]",0.0003,0.002,0.0015,5
1458,0.006549999999999896,0.75,6,3,3,12,8,4,8,17,15,1,0.1,"[0, 20, 40]",0.0005,0.001,0.001,1
1459,0.022199999999998776,0.7142857142857143,17,14,18,49,34,15,8,17,15,1,0.1,"[0, 20, 40]",0.0005,0.001,0.001,3
1460,0.026659999999997918,0.6153846153846154,25,17,36,78,62,16,8,17,15,1,0.1,"[0, 20, 40]",0.0005,0.001,0.001,5
1461,0.004749999999999816,0.6666666666666666,7,1,4,12,8,4,8,17,15,1,0.1,"[0, 20, 40]",0.0005,0.001,0.0015,1
1462,0.014879999999998516,0.5918367346938775,18,7,24,49,34,15,8,17,15,1,0.1,"[0, 20, 40]",0.0005,0.001,0.0015,3
1463,0.020839999999997666,0.5384615384615384,26,10,42,78,62,16,8,17,15,1,0.1,"[0, 20, 40]",0.0005,0.001,0.0015,5
1464,0.003919999999999488,0.5833333333333334,1,3,8,12,8,4,8,17,15,1,0.1,"[0, 20, 40]",0.0005,0.0015,0.001,1
1465,0.02269999999999817,0.673469387755102,8,14,27,49,34,15,8,17,15,1,0.1,"[0, 20, 40]",0.0005,0.0015,0.001,3
1466,0.029369999999997086,0.5897435897435898,13,17,48,78,62,16,8,17,15,1,0.1,"[0, 20, 40]",0.0005,0.0015,0.001,5
1467,0.0026199999999994097,0.5,2,1,9,12,8,4,8,17,15,1,0.1,"[0, 20, 40]",0.0005,0.0015,0.0015,1
1468,0.015879999999997906,0.5510204081632653,9,7,33,49,34,15,8,17,15,1,0.1,"[0, 20, 40]",0.0005,0.0015,0.0015,3
1469,0.02404999999999682,0.5128205128205128,14,10,54,78,62,16,8,17,15,1,0.1,"[0, 20, 40]",0.0005,0.0015,0.0015,5
1470,0.004419999999999489,0.5833333333333334,1,3,8,12,8,4,8,17,15,1,0.1,"[0, 20, 40]",0.0005,0.002,0.001,1
1471,0.022569999999997765,0.6530612244897959,4,14,31,49,34,15,8,17,15,1,0.1,"[0, 20, 40]",0.0005,0.002,0.001,3
1472,0.02881999999999643,0.5641025641025641,6,17,55,78,62,16,8,17,15,1,0.1,"[0, 20, 40]",0.0005,0.002,0.001,5
1473,0.0036199999999994097,0.5,2,1,9,12,8,4,8,17,15,1,0.1,"[0, 20, 40]",0.0005,0.002,0.0015,1
1474,0.016249999999997496,0.5306122448979592,5,7,37,49,34,15,8,17,15,1,0.1,"[0, 20, 40]",0.0005,0.002,0.0015,3
1475,0.02399999999999617,0.48717948717948717,7,10,61,78,62,16,8,17,15,1,0.1,"[0, 20, 40]",0.0005,0.002,0.0015,5
1476,0.008699999999999392,0.6666666666666666,8,6,10,24,19,5,8,17,15,1,0.2,"[0, 20, 40]",0.0003,0.001,0.001,1
1477,0.007969999999997944,0.4897959183673469,10,9,30,49,40,9,8,17,15,1,0.2,"[0, 20, 40]",0.0003,0.001,0.001,3
1478,0.012939999999998012,0.5,13,12,37,62,51,11,8,17,15,1,0.2,"[0, 20, 40]",0.0003,0.001,0.001,5
1479,0.004509999999999588,0.5416666666666666,8,2,14,24,19,5,8,17,15,1,0.2,"[0, 20, 40]",0.0003,0.001,0.0015,1
1480,0.003269999999997901,0.40816326530612246,10,4,35,49,40,9,8,17,15,1,0.2,"[0, 20, 40]",0.0003,0.001,0.0015,3
1481,0.007079999999998147,0.41935483870967744,13,6,43,62,51,11,8,17,15,1,0.2,"[0, 20, 40]",0.0003,0.001,0.0015,5
1482,0.009969999999999162,0.625,4,7,13,24,19,5,8,17,15,1,0.2,"[0, 20, 40]",0.0003,0.0015,0.001,1
1483,0.009459999999997604,0.46938775510204084,4,10,35,49,40,9,8,17,15,1,0.2,"[0, 20, 40]",0.0003,0.0015,0.001,3
1484,0.012729999999997526,0.46774193548387094,4,13,45,62,51,11,8,17,15,1,0.2,"[0, 20, 40]",0.0003,0.0015,0.001,5
1485,0.00577999999999925,0.5,4,2,18,24,19,5,8,17,15,1,0.2,"[0, 20, 40]",0.0003,0.0015,0.0015,1
1486,0.004759999999997452,0.3877551020408163,4,4,41,49,40,9,8,17,15,1,0.2,"[0, 20, 40]",0.0003,0.0015,0.0015,3
1487,0.006869999999997553,0.3870967741935484,4,6,52,62,51,11,8,17,15,1,0.2,"[0, 20, 40]",0.0003,0.0015,0.0015,5
1488,0.009499999999999197,0.5833333333333334,2,7,15,24,19,5,8,17,15,1,0.2,"[0, 20, 40]",0.0003,0.002,0.001,1
1489,0.008989999999997637,0.4489795918367347,2,10,37,49,40,9,8,17,15,1,0.2,"[0, 20, 40]",0.0003,0.002,0.001,3
1490,0.01225999999999756,0.45161290322580644,2,13,47,62,51,11,8,17,15,1,0.2,"[0, 20, 40]",0.0003,0.002,0.001,5
1491,0.005309999999999283,0.4583333333333333,2,2,20,24,19,5,8,17,15,1,0.2,"[0, 20, 40]",0.0003,0.002,0.0015,1
1492,0.004289999999997482,0.3673469387755102,2,4,43,49,40,9,8,17,15,1,0.2,"[0, 20, 40]",0.0003,0.002,0.0015,3
1493,0.006399999999997584,0.3709677419354839,2,6,54,62,51,11,8,17,15,1,0.2,"[0, 20, 40]",0.0003,0.002,0.0015,5
1494,0.0017899999999999566,0.6,3,0,2,5,4,1,8,17,15,1,0.2,"[0, 20, 40]",0.0005,0.001,0.001,1
1495,0.009019999999999114,0.6153846153846154,8,5,13,26,21,5,8,17,15,1,0.2,"[0, 20, 40]",0.0005,0.001,0.001,3
1496,0.011119999999998279,0.5116279069767442,11,8,24,43,38,5,8,17,15,1,0.2,"[0, 20, 40]",0.0005,0.001,0.001,5
1497,0.0017899999999999566,0.6,3,0,2,5,4,1,8,17,15,1,0.2,"[0, 20, 40]",0.0005,0.001,0.0015,1
1498,0.007239999999998941,0.5384615384615384,8,3,15,26,21,5,8,17,15,1,0.2,"[0, 20, 40]",0.0005,0.001,0.0015,3
1499,0.010839999999998108,0.46511627906976744,11,6,26,43,38,5,8,17,15,1,0.2,"[0, 20, 40]",0.0005,0.001,0.0015,5
1500,0.0005399999999995959,0.4,1,0,4,5,4,1,8,17,15,1,0.2,"[0, 20, 40]",0.0005,0.0015,0.001,1
1501,0.00925999999999869,0.5769230769230769,4,5,17,26,21,5,8,17,15,1,0.2,"[0, 20, 40]",0.0005,0.0015,0.001,3
1502,0.011749999999997802,0.4883720930232558,5,8,30,43,38,5,8,17,15,1,0.2,"[0, 20, 40]",0.0005,0.0015,0.001,5
1503,0.0005399999999995959,0.4,1,0,4,5,4,1,8,17,15,1,0.2,"[0, 20, 40]",0.0005,0.0015,0.0015,1
1504,0.007479999999998517,0.5,4,3,19,26,21,5,8,17,15,1,0.2,"[0, 20, 40]",0.0005,0.0015,0.0015,3
1505,0.011469999999997626,0.4418604651162791,5,6,32,43,38,5,8,17,15,1,0.2,"[0, 20, 40]",0.0005,0.0015,0.0015,5
1506,0.001039999999999596,0.4,1,0,4,5,4,1,8,17,15,1,0.2,"[0, 20, 40]",0.0005,0.002,0.001,1
1507,0.009289999999998445,0.5769230769230769,1,5,20,26,21,5,8,17,15,1,0.2,"[0, 20, 40]",0.0005,0.002,0.001,3
1508,0.011459999999997519,0.4883720930232558,1,8,34,43,38,5,8,17,15,1,0.2,"[0, 20, 40]",0.0005,0.002,0.001,5
1509,0.001039999999999596,0.4,1,0,4,5,4,1,8,17,15,1,0.2,"[0, 20, 40]",0.0005,0.002,0.0015,1
1510,0.007509999999998275,0.5,1,3,22,26,21,5,8,17,15,1,0.2,"[0, 20, 40]",0.0005,0.002,0.0015,3
1511,0.011179999999997343,0.4418604651162791,1,6,36,43,38,5,8,17,15,1,0.2,"[0, 20, 40]",0.0005,0.002,0.0015,5
1512,0.00577999999999918,0.4864864864864865,8,7,22,37,27,10,8,17,15,2,0.1,"[0, 20, 40]",0.0003,0.001,0.001,1
1513,0.012599999999997379,0.4823529411764706,16,18,51,85,66,19,8,17,15,2,0.1,"[0, 20, 40]",0.0003,0.001,0.001,3
1514,0.01867999999999726,0.49038461538461536,20,22,62,104,83,21,8,17,15,2,0.1,"[0, 20, 40]",0.0003,0.001,0.001,5
1515,0.006139999999999374,0.4594594594594595,8,5,24,37,27,10,8,17,15,2,0.1,"[0, 20, 40]",0.0003,0.001,0.0015,1
1516,0.011699999999997192,0.43529411764705883,16,13,56,85,66,19,8,17,15,2,0.1,"[0, 20, 40]",0.0003,0.001,0.0015,3
1517,0.016619999999997238,0.4423076923076923,21,15,68,104,83,21,8,17,15,2,0.1,"[0, 20, 40]",0.0003,0.001,0.0015,5
1518,0.005199999999998713,0.4594594594594595,2,8,27,37,27,10,8,17,15,2,0.1,"[0, 20, 40]",0.0003,0.0015,0.001,1
1519,0.01311999999999657,0.4588235294117647,6,19,60,85,66,19,8,17,15,2,0.1,"[0, 20, 40]",0.0003,0.0015,0.001,3
1520,0.017439999999996247,0.46153846153846156,6,23,75,104,83,21,8,17,15,2,0.1,"[0, 20, 40]",0.0003,0.0015,0.001,5
1521,0.005559999999998796,0.43243243243243246,2,5,30,37,27,10,8,17,15,2,0.1,"[0, 20, 40]",0.0003,0.0015,0.0015,1
1522,0.012219999999996274,0.4117647058823529,6,13,66,85,66,19,8,17,15,2,0.1,"[0, 20, 40]",0.0003,0.0015,0.0015,3
1523,0.01587999999999612,0.41346153846153844,7,15,82,104,83,21,8,17,15,2,0.1,"[0, 20, 40]",0.0003,0.0015,0.0015,5
1524,0.006199999999998713,0.4594594594594595,2,8,27,37,27,10,8,17,15,2,0.1,"[0, 20, 40]",0.0003,0.002,0.001,1
1525,0.015509999999996573,0.4588235294117647,5,19,61,85,66,19,8,17,15,2,0.1,"[0, 20, 40]",0.0003,0.002,0.001,3
1526,0.019829999999996253,0.46153846153846156,5,23,76,104,83,21,8,17,15,2,0.1,"[0, 20, 40]",0.0003,0.002,0.001,5
1527,0.006559999999998797,0.43243243243243246,2,5,30,37,27,10,8,17,15,2,0.1,"[0, 20, 40]",0.0003,0.002,0.0015,1
1528,0.014609999999996275,0.4117647058823529,5,13,67,85,66,19,8,17,15,2,0.1,"[0, 20, 40]",0.0003,0.002,0.0015,3
1529,0.018769999999996123,0.41346153846153844,6,15,83,104,83,21,8,17,15,2,0.1,"[0, 20, 40]",0.0003,0.002,0.0015,5
1530,0.005359999999999962,0.6153846153846154,6,2,5,13,10,3,8,17,15,2,0.1,"[0, 20, 40]",0.0005,0.001,0.001,1
1531,0.018549999999999147,0.6829268292682927,14,12,15,41,35,6,8,17,15,2,0.1,"[0, 20, 40]",0.0005,0.001,0.001,3
1532,0.024919999999998388,0.625,21,15,28,64,58,6,8,17,15,2,0.1,"[0, 20, 40]",0.0005,0.001,0.001,5
1533,0.0035599999999998805,0.5384615384615384,6,1,6,13,10,3,8,17,15,2,0.1,"[0, 20, 40]",0.0005,0.001,0.0015,1
1534,0.013149999999998687,0.5609756097560976,14,7,20,41,35,6,8,17,15,2,0.1,"[0, 20, 40]",0.0005,0.001,0.0015,3
1535,0.021019999999997936,0.546875,21,10,33,64,58,6,8,17,15,2,0.1,"[0, 20, 40]",0.0005,0.001,0.0015,5
1536,0.002729999999999554,0.46153846153846156,1,2,10,13,10,3,8,17,15,2,0.1,"[0, 20, 40]",0.0005,0.0015,0.001,1
1537,0.017549999999998536,0.6341463414634146,5,12,24,41,35,6,8,17,15,2,0.1,"[0, 20, 40]",0.0005,0.0015,0.001,3
1538,0.026309999999997724,0.59375,10,15,39,64,58,6,8,17,15,2,0.1,"[0, 20, 40]",0.0005,0.0015,0.001,5
1539,0.0009299999999994753,0.38461538461538464,1,1,11,13,10,3,8,17,15,2,0.1,"[0, 20, 40]",0.0005,0.0015,0.0015,1
1540,0.012149999999998074,0.5121951219512195,5,7,29,41,35,6,8,17,15,2,0.1,"[0, 20, 40]",0.0005,0.0015,0.0015,3
1541,0.022409999999997276,0.515625,10,10,44,64,58,6,8,17,15,2,0.1,"[0, 20, 40]",0.0005,0.0015,0.0015,5
1542,0.003229999999999554,0.46153846153846156,1,2,10,13,10,3,8,17,15,2,0.1,"[0, 20, 40]",0.0005,0.002,0.001,1
1543,0.017289999999998442,0.6097560975609756,3,12,26,41,35,6,8,17,15,2,0.1,"[0, 20, 40]",0.0005,0.002,0.001,3
1544,0.02562999999999739,0.5625,5,15,44,64,58,6,8,17,15,2,0.1,"[0, 20, 40]",0.0005,0.002,0.001,5
1545,0.0014299999999994753,0.38461538461538464,1,1,11,13,10,3,8,17,15,2,0.1,"[0, 20, 40]",0.0005,0.002,0.0015,1
1546,0.01188999999999798,0.4878048780487805,3,7,31,41,35,6,8,17,15,2,0.1,"[0, 20, 40]",0.0005,0.002,0.0015,3
1547,0.021729999999996936,0.484375,5,10,49,64,58,6,8,17,15,2,0.1,"[0, 20, 40]",0.0005,0.002,0.0015,5
1548,0.004819999999999975,0.5555555555555556,5,4,9,18,17,1,8,17,15,2,0.2,"[0, 20, 40]",0.0003,0.001,0.001,1
1549,0.007649999999999112,0.5,7,10,25,42,38,4,8,17,15,2,0.2,"[0, 20, 40]",0.0003,0.001,0.001,3
1550,0.013279999999999067,0.5272727272727272,9,14,32,55,49,6,8,17,15,2,0.2,"[0, 20, 40]",0.0003,0.001,0.001,5
1551,0.004760000000000081,0.5,5,3,10,18,17,1,8,17,15,2,0.2,"[0, 20, 40]",0.0003,0.001,0.0015,1
1552,0.006149999999998881,0.42857142857142855,7,7,28,42,38,4,8,17,15,2,0.2,"[0, 20, 40]",0.0003,0.001,0.0015,3
1553,0.010619999999999005,0.45454545454545453,10,9,36,55,49,6,8,17,15,2,0.2,"[0, 20, 40]",0.0003,0.001,0.0015,5
1554,0.004349999999999728,0.5,1,5,12,18,17,1,8,17,15,2,0.2,"[0, 20, 40]",0.0003,0.0015,0.001,1
1555,0.006659999999998733,0.4523809523809524,2,11,29,42,38,4,8,17,15,2,0.2,"[0, 20, 40]",0.0003,0.0015,0.001,3
1556,0.010609999999998784,0.4727272727272727,2,15,38,55,49,6,8,17,15,2,0.2,"[0, 20, 40]",0.0003,0.0015,0.001,5
1557,0.004289999999999725,0.4444444444444444,1,3,14,18,17,1,8,17,15,2,0.2,"[0, 20, 40]",0.0003,0.0015,0.0015,1
1558,0.005159999999998393,0.38095238095238093,2,7,33,42,38,4,8,17,15,2,0.2,"[0, 20, 40]",0.0003,0.0015,0.0015,3
1559,0.00844999999999862,0.4,3,9,43,55,49,6,8,17,15,2,0.2,"[0, 20, 40]",0.0003,0.0015,0.0015,5
1560,0.004849999999999729,0.5,1,5,12,18,17,1,8,17,15,2,0.2,"[0, 20, 40]",0.0003,0.002,0.001,1
1561,0.007659999999998736,0.4523809523809524,2,11,29,42,38,4,8,17,15,2,0.2,"[0, 20, 40]",0.0003,0.002,0.001,3
1562,0.011609999999998783,0.4727272727272727,2,15,38,55,49,6,8,17,15,2,0.2,"[0, 20, 40]",0.0003,0.002,0.001,5
1563,0.004789999999999725,0.4444444444444444,1,3,14,18,17,1,8,17,15,2,0.2,"[0, 20, 40]",0.0003,0.002,0.0015,1
1564,0.006159999999998394,0.38095238095238093,2,7,33,42,38,4,8,17,15,2,0.2,"[0, 20, 40]",0.0003,0.002,0.0015,3
1565,0.00994999999999862,0.4,3,9,43,55,49,6,8,17,15,2,0.2,"[0, 20, 40]",0.0003,0.002,0.0015,5
1566,0.0007899999999999566,0.4,1,1,3,5,5,0,8,17,15,2,0.2,"[0, 20, 40]",0.0005,0.001,0.001,1
1567,0.006929999999999433,0.6,4,6,10,20,19,1,8,17,15,2,0.2,"[0, 20, 40]",0.0005,0.001,0.001,3
1568,0.011419999999998934,0.5405405405405406,9,9,19,37,36,1,8,17,15,2,0.2,"[0, 20, 40]",0.0005,0.001,0.001,5
1569,0.0012899999999999565,0.4,1,1,3,5,5,0,8,17,15,2,0.2,"[0, 20, 40]",0.0005,0.001,0.0015,1
1570,0.0060299999999990864,0.5,4,4,12,20,19,1,8,17,15,2,0.2,"[0, 20, 40]",0.0005,0.001,0.0015,3
1571,0.012019999999998586,0.4864864864864865,9,7,21,37,36,1,8,17,15,2,0.2,"[0, 20, 40]",0.0005,0.001,0.0015,5
1572,0.000739999999999741,0.4,0,1,4,5,5,0,8,17,15,2,0.2,"[0, 20, 40]",0.0005,0.0015,0.001,1
1573,0.007369999999999153,0.6,1,6,13,20,19,1,8,17,15,2,0.2,"[0, 20, 40]",0.0005,0.0015,0.001,3
1574,0.013249999999998601,0.5405405405405406,4,9,24,37,36,1,8,17,15,2,0.2,"[0, 20, 40]",0.0005,0.0015,0.001,5
1575,0.0012399999999997409,0.4,0,1,4,5,5,0,8,17,15,2,0.2,"[0, 20, 40]",0.0005,0.0015,0.0015,1
1576,0.006469999999998807,0.5,1,4,15,20,19,1,8,17,15,2,0.2,"[0, 20, 40]",0.0005,0.0015,0.0015,3
1577,0.01384999999999825,0.4864864864864865,4,7,26,37,36,1,8,17,15,2,0.2,"[0, 20, 40]",0.0005,0.0015,0.0015,5
1578,0.000739999999999741,0.4,0,1,4,5,5,0,8,17,15,2,0.2,"[0, 20, 40]",0.0005,0.002,0.001,1
1579,0.007869999999999154,0.6,1,6,13,20,19,1,8,17,15,2,0.2,"[0, 20, 40]",0.0005,0.002,0.001,3
1580,0.014169999999998415,0.5405405405405406,2,9,26,37,36,1,8,17,15,2,0.2,"[0, 20, 40]",0.0005,0.002,0.001,5
1581,0.0012399999999997409,0.4,0,1,4,5,5,0,8,17,15,2,0.2,"[0, 20, 40]",0.0005,0.002,0.0015,1
1582,0.006969999999998807,0.5,1,4,15,20,19,1,8,17,15,2,0.2,"[0, 20, 40]",0.0005,0.002,0.0015,3
1583,0.014769999999998064,0.4864864864864865,2,7,28,37,36,1,8,17,15,2,0.2,"[0, 20, 40]",0.0005,0.002,0.0015,5
1584,0.020400000000000085,0.673469387755102,16,17,16,49,32,17,8,17,20,1,0.1,"[0, 20, 40]",0.0003,0.001,0.001,1
1585,0.03307999999999925,0.6521739130434783,25,31,36,92,63,29,8,17,20,1,0.1,"[0, 20, 40]",0.0003,0.001,0.001,3
1586,0.04185999999999886,0.6551724137931034,33,36,47,116,83,33,8,17,20,1,0.1,"[0, 20, 40]",0.0003,0.001,0.001,5
1587,0.01663000000000015,0.5510204081632653,17,10,22,49,32,17,8,17,20,1,0.1,"[0, 20, 40]",0.0003,0.001,0.0015,1
1588,0.019999999999999338,0.5,25,17,50,92,63,29,8,17,20,1,0.1,"[0, 20, 40]",0.0003,0.001,0.0015,3
1589,0.03139999999999898,0.5431034482758621,34,21,61,116,82,34,8,17,20,1,0.1,"[0, 20, 40]",0.0003,0.001,0.0015,5
1590,0.023179999999999805,0.6530612244897959,9,19,21,49,32,17,8,17,20,1,0.1,"[0, 20, 40]",0.0003,0.0015,0.001,1
1591,0.03489999999999852,0.6086956521739131,12,34,46,92,63,29,8,17,20,1,0.1,"[0, 20, 40]",0.0003,0.0015,0.001,3
1592,0.04416999999999792,0.6120689655172413,16,40,60,116,83,33,8,17,20,1,0.1,"[0, 20, 40]",0.0003,0.0015,0.001,5
1593,0.020909999999999866,0.5306122448979592,12,10,27,49,32,17,8,17,20,1,0.1,"[0, 20, 40]",0.0003,0.0015,0.0015,1
1594,0.023319999999998595,0.45652173913043476,14,18,60,92,63,29,8,17,20,1,0.1,"[0, 20, 40]",0.0003,0.0015,0.0015,3
1595,0.03414999999999791,0.49137931034482757,19,22,75,116,82,34,8,17,20,1,0.1,"[0, 20, 40]",0.0003,0.0015,0.0015,5
1596,0.02409999999999946,0.6530612244897959,4,19,26,49,32,17,8,17,20,1,0.1,"[0, 20, 40]",0.0003,0.002,0.001,1
1597,0.0373699999999983,0.6086956521739131,7,34,51,92,63,29,8,17,20,1,0.1,"[0, 20, 40]",0.0003,0.002,0.001,3
1598,0.04506999999999753,0.6086956521739131,8,39,68,115,83,32,8,17,20,1,0.1,"[0, 20, 40]",0.0003,0.002,0.001,5
1599,0.02253999999999967,0.5306122448979592,6,10,33,49,32,17,8,17,20,1,0.1,"[0, 20, 40]",0.0003,0.002,0.0015,1
1600,0.026789999999998346,0.45652173913043476,9,18,65,92,63,29,8,17,20,1,0.1,"[0, 20, 40]",0.0003,0.002,0.0015,3
1601,0.036049999999997515,0.48695652173913045,11,21,83,115,82,33,8,17,20,1,0.1,"[0, 20, 40]",0.0003,0.002,0.0015,5
1602,0.007339999999999853,0.8333333333333334,6,4,2,12,8,4,8,17,20,1,0.1,"[0, 20, 40]",0.0005,0.001,0.001,1
1603,0.02038999999999931,0.6956521739130435,16,14,16,46,33,13,8,17,20,1,0.1,"[0, 20, 40]",0.0005,0.001,0.001,3
1604,0.02894999999999881,0.6575342465753424,24,20,29,73,59,14,8,17,20,1,0.1,"[0, 20, 40]",0.0005,0.001,0.001,5
1605,0.0044199999999996525,0.6666666666666666,7,1,4,12,8,4,8,17,20,1,0.1,"[0, 20, 40]",0.0005,0.001,0.0015,1
1606,0.016299999999998965,0.5777777777777777,16,8,21,45,32,13,8,17,20,1,0.1,"[0, 20, 40]",0.0005,0.001,0.0015,3
1607,0.02305999999999846,0.5555555555555556,24,12,36,72,58,14,8,17,20,1,0.1,"[0, 20, 40]",0.0005,0.001,0.0015,5
1608,0.004529999999999708,0.5833333333333334,1,5,6,12,8,4,8,17,20,1,0.1,"[0, 20, 40]",0.0005,0.0015,0.001,1
1609,0.020239999999999106,0.6304347826086957,8,15,23,46,33,13,8,17,20,1,0.1,"[0, 20, 40]",0.0005,0.0015,0.001,3
1610,0.031049999999998204,0.6164383561643836,13,21,39,73,59,14,8,17,20,1,0.1,"[0, 20, 40]",0.0005,0.0015,0.001,5
1611,0.00028999999999946647,0.3333333333333333,2,1,9,12,8,4,8,17,20,1,0.1,"[0, 20, 40]",0.0005,0.0015,0.0015,1
1612,0.014329999999998715,0.4888888888888889,8,8,29,45,32,13,8,17,20,1,0.1,"[0, 20, 40]",0.0005,0.0015,0.0015,3
1613,0.023339999999997793,0.5,13,12,47,72,58,14,8,17,20,1,0.1,"[0, 20, 40]",0.0005,0.0015,0.0015,5
1614,0.005029999999999708,0.5833333333333334,1,5,6,12,8,4,8,17,20,1,0.1,"[0, 20, 40]",0.0005,0.002,0.001,1
1615,0.021859999999998617,0.6304347826086957,5,15,26,46,33,13,8,17,20,1,0.1,"[0, 20, 40]",0.0005,0.002,0.001,3
1616,0.03232999999999711,0.6164383561643836,7,21,45,73,59,14,8,17,20,1,0.1,"[0, 20, 40]",0.0005,0.002,0.001,5
1617,0.0012899999999994665,0.3333333333333333,2,1,9,12,8,4,8,17,20,1,0.1,"[0, 20, 40]",0.0005,0.002,0.0015,1
1618,0.017309999999998472,0.4888888888888889,6,8,31,45,32,13,8,17,20,1,0.1,"[0, 20, 40]",0.0005,0.002,0.0015,3
1619,0.025979999999996943,0.5,8,12,52,72,58,14,8,17,20,1,0.1,"[0, 20, 40]",0.0005,0.002,0.0015,5
1620,0.011160000000000073,0.7083333333333334,10,7,7,24,19,5,8,17,20,1,0.2,"[0, 20, 40]",0.0003,0.001,0.001,1
1621,0.01438999999999987,0.6086956521739131,13,12,21,46,37,9,8,17,20,1,0.2,"[0, 20, 40]",0.0003,0.001,0.001,3
1622,0.019339999999999944,0.6206896551724138,17,15,26,58,47,11,8,17,20,1,0.2,"[0, 20, 40]",0.0003,0.001,0.001,5
1623,0.008579999999999933,0.5833333333333334,10,4,10,24,19,5,8,17,20,1,0.2,"[0, 20, 40]",0.0003,0.001,0.0015,1
1624,0.010079999999999666,0.5,13,7,26,46,37,9,8,17,20,1,0.2,"[0, 20, 40]",0.0003,0.001,0.0015,3
1625,0.01652999999999973,0.5344827586206896,17,10,31,58,47,11,8,17,20,1,0.2,"[0, 20, 40]",0.0003,0.001,0.0015,5
1626,0.013889999999999911,0.7083333333333334,7,8,9,24,19,5,8,17,20,1,0.2,"[0, 20, 40]",0.0003,0.0015,0.001,1
1627,0.017329999999999415,0.6086956521739131,7,13,26,46,37,9,8,17,20,1,0.2,"[0, 20, 40]",0.0003,0.0015,0.001,3
1628,0.022779999999999433,0.6206896551724138,9,17,32,58,47,11,8,17,20,1,0.2,"[0, 20, 40]",0.0003,0.0015,0.001,5
1629,0.011809999999999772,0.5833333333333334,8,4,12,24,19,5,8,17,20,1,0.2,"[0, 20, 40]",0.0003,0.0015,0.0015,1
1630,0.013519999999999224,0.5,8,7,31,46,37,9,8,17,20,1,0.2,"[0, 20, 40]",0.0003,0.0015,0.0015,3
1631,0.01890999999999911,0.5172413793103449,10,10,38,58,47,11,8,17,20,1,0.2,"[0, 20, 40]",0.0003,0.0015,0.0015,5
1632,0.014369999999999676,0.7083333333333334,3,8,13,24,19,5,8,17,20,1,0.2,"[0, 20, 40]",0.0003,0.002,0.001,1
1633,0.018849999999999326,0.6086956521739131,4,13,29,46,37,9,8,17,20,1,0.2,"[0, 20, 40]",0.0003,0.002,0.001,3
1634,0.0225099999999992,0.6140350877192983,4,16,37,57,47,10,8,17,20,1,0.2,"[0, 20, 40]",0.0003,0.002,0.001,5
1635,0.012789999999999538,0.5833333333333334,4,4,16,24,19,5,8,17,20,1,0.2,"[0, 20, 40]",0.0003,0.002,0.0015,1
1636,0.015539999999999133,0.5,5,7,34,46,37,9,8,17,20,1,0.2,"[0, 20, 40]",0.0003,0.002,0.0015,3
1637,0.018639999999998866,0.5087719298245614,5,9,43,57,47,10,8,17,20,1,0.2,"[0, 20, 40]",0.0003,0.002,0.0015,5
1638,0.0030899999999999235,0.8,3,1,1,5,4,1,8,17,20,1,0.2,"[0, 20, 40]",0.0005,0.001,0.001,1
1639,0.010039999999999692,0.6153846153846154,8,6,12,26,21,5,8,17,20,1,0.2,"[0, 20, 40]",0.0005,0.001,0.001,3
1640,0.014269999999999505,0.5952380952380952,12,10,20,42,37,5,8,17,20,1,0.2,"[0, 20, 40]",0.0005,0.001,0.001,5
1641,0.0013099999999999206,0.6,3,0,2,5,4,1,8,17,20,1,0.2,"[0, 20, 40]",0.0005,0.001,0.0015,1
1642,0.009249999999999618,0.5384615384615384,8,4,14,26,21,5,8,17,20,1,0.2,"[0, 20, 40]",0.0005,0.001,0.0015,3
1643,0.013219999999999343,0.5238095238095238,12,7,23,42,37,5,8,17,20,1,0.2,"[0, 20, 40]",0.0005,0.001,0.0015,5
1644,0.00341999999999981,0.8,1,2,2,5,4,1,8,17,20,1,0.2,"[0, 20, 40]",0.0005,0.0015,0.001,1
1645,0.012249999999999567,0.6153846153846154,5,7,14,26,21,5,8,17,20,1,0.2,"[0, 20, 40]",0.0005,0.0015,0.001,3
1646,0.016979999999999048,0.5952380952380952,6,11,25,42,37,5,8,17,20,1,0.2,"[0, 20, 40]",0.0005,0.0015,0.001,5
1647,-0.0001800000000002364,0.4,1,0,4,5,4,1,8,17,20,1,0.2,"[0, 20, 40]",0.0005,0.0015,0.0015,1
1648,0.009639999999999451,0.5,5,4,17,26,21,5,8,17,20,1,0.2,"[0, 20, 40]",0.0005,0.0015,0.0015,3
1649,0.014109999999998846,0.5,6,7,29,42,37,5,8,17,20,1,0.2,"[0, 20, 40]",0.0005,0.0015,0.0015,5
1650,0.00391999999999981,0.8,1,2,2,5,4,1,8,17,20,1,0.2,"[0, 20, 40]",0.0005,0.002,0.001,1
1651,0.013729999999999328,0.6153846153846154,3,7,16,26,21,5,8,17,20,1,0.2,"[0, 20, 40]",0.0005,0.002,0.001,3
1652,0.01773999999999859,0.5952380952380952,3,11,28,42,37,5,8,17,20,1,0.2,"[0, 20, 40]",0.0005,0.002,0.001,5
1653,0.0003199999999997636,0.4,1,0,4,5,4,1,8,17,20,1,0.2,"[0, 20, 40]",0.0005,0.002,0.0015,1
1654,0.011119999999999212,0.5,3,4,19,26,21,5,8,17,20,1,0.2,"[0, 20, 40]",0.0005,0.002,0.0015,3
1655,0.014869999999998388,0.5,3,7,32,42,37,5,8,17,20,1,0.2,"[0, 20, 40]",0.0005,0.002,0.0015,5
1656,0.009990000000000023,0.5555555555555556,10,10,16,36,27,9,8,17,20,2,0.1,"[0, 20, 40]",0.0003,0.001,0.001,1
1657,0.02263999999999913,0.5641025641025641,18,22,38,78,61,17,8,17,20,2,0.1,"[0, 20, 40]",0.0003,0.001,0.001,3
1658,0.030549999999999237,0.59375,25,27,44,96,77,19,8,17,20,2,0.1,"[0, 20, 40]",0.0003,0.001,0.001,5
1659,0.0111700000000002,0.5,10,8,18,36,27,9,8,17,20,2,0.1,"[0, 20, 40]",0.0003,0.001,0.0015,1
1660,0.023819999999999255,0.5,18,17,43,78,61,17,8,17,20,2,0.1,"[0, 20, 40]",0.0003,0.001,0.0015,3
1661,0.033949999999999515,0.5473684210526316,26,21,48,95,76,19,8,17,20,2,0.1,"[0, 20, 40]",0.0003,0.001,0.0015,5
1662,0.01026999999999975,0.5277777777777778,4,11,21,36,27,9,8,17,20,2,0.1,"[0, 20, 40]",0.0003,0.0015,0.001,1
1663,0.021489999999998368,0.5256410256410257,6,24,48,78,61,17,8,17,20,2,0.1,"[0, 20, 40]",0.0003,0.0015,0.001,3
1664,0.030549999999998245,0.5625,10,30,56,96,77,19,8,17,20,2,0.1,"[0, 20, 40]",0.0003,0.0015,0.001,5
1665,0.011949999999999926,0.4722222222222222,5,8,23,36,27,9,8,17,20,2,0.1,"[0, 20, 40]",0.0003,0.0015,0.0015,1
1666,0.023669999999998494,0.46153846153846156,7,18,53,78,61,17,8,17,20,2,0.1,"[0, 20, 40]",0.0003,0.0015,0.0015,3
1667,0.033889999999998394,0.5052631578947369,12,22,61,95,76,19,8,17,20,2,0.1,"[0, 20, 40]",0.0003,0.0015,0.0015,5
1668,0.011709999999999639,0.5277777777777778,3,11,22,36,27,9,8,17,20,2,0.1,"[0, 20, 40]",0.0003,0.002,0.001,1
1669,0.02293999999999821,0.5256410256410257,4,24,50,78,61,17,8,17,20,2,0.1,"[0, 20, 40]",0.0003,0.002,0.001,3
1670,0.03122999999999794,0.5625,5,30,61,96,77,19,8,17,20,2,0.1,"[0, 20, 40]",0.0003,0.002,0.001,5
1671,0.013889999999999812,0.4722222222222222,4,8,24,36,27,9,8,17,20,2,0.1,"[0, 20, 40]",0.0003,0.002,0.0015,1
1672,0.025619999999998335,0.46153846153846156,5,18,55,78,61,17,8,17,20,2,0.1,"[0, 20, 40]",0.0003,0.002,0.0015,3
1673,0.03556999999999808,0.5052631578947369,7,22,66,95,76,19,8,17,20,2,0.1,"[0, 20, 40]",0.0003,0.002,0.0015,5
1674,0.007459999999999951,0.7692307692307693,6,4,3,13,10,3,8,17,20,2,0.1,"[0, 20, 40]",0.0005,0.001,0.001,1
1675,0.021359999999999588,0.75,14,14,12,40,34,6,8,17,20,2,0.1,"[0, 20, 40]",0.0005,0.001,0.001,3
1676,0.029659999999999496,0.7096774193548387,22,18,22,62,56,6,8,17,20,2,0.1,"[0, 20, 40]",0.0005,0.001,0.001,5
1677,0.00503999999999975,0.6153846153846154,6,2,5,13,10,3,8,17,20,2,0.1,"[0, 20, 40]",0.0005,0.001,0.0015,1
1678,0.01773999999999926,0.6153846153846154,13,9,17,39,33,6,8,17,20,2,0.1,"[0, 20, 40]",0.0005,0.001,0.0015,3
1679,0.025779999999999095,0.6065573770491803,21,12,28,61,55,6,8,17,20,2,0.1,"[0, 20, 40]",0.0005,0.001,0.0015,5
1680,0.004649999999999805,0.5384615384615384,1,5,7,13,10,3,8,17,20,2,0.1,"[0, 20, 40]",0.0005,0.0015,0.001,1
1681,0.019899999999999186,0.675,5,15,20,40,34,6,8,17,20,2,0.1,"[0, 20, 40]",0.0005,0.0015,0.001,3
1682,0.030699999999998766,0.6612903225806451,10,19,33,62,56,6,8,17,20,2,0.1,"[0, 20, 40]",0.0005,0.0015,0.001,5
1683,0.00040999999999956436,0.3076923076923077,1,2,10,13,10,3,8,17,20,2,0.1,"[0, 20, 40]",0.0005,0.0015,0.0015,1
1684,0.013959999999998814,0.5128205128205128,4,9,26,39,33,6,8,17,20,2,0.1,"[0, 20, 40]",0.0005,0.0015,0.0015,3
1685,0.024499999999998325,0.5409836065573771,9,12,40,61,55,6,8,17,20,2,0.1,"[0, 20, 40]",0.0005,0.0015,0.0015,5
1686,0.005149999999999806,0.5384615384615384,1,5,7,13,10,3,8,17,20,2,0.1,"[0, 20, 40]",0.0005,0.002,0.001,1
1687,0.020319999999998884,0.675,3,15,22,40,34,6,8,17,20,2,0.1,"[0, 20, 40]",0.0005,0.002,0.001,3
1688,0.030779999999997858,0.6612903225806451,5,19,38,62,56,6,8,17,20,2,0.1,"[0, 20, 40]",0.0005,0.002,0.001,5
1689,0.0009099999999995644,0.3076923076923077,1,2,10,13,10,3,8,17,20,2,0.1,"[0, 20, 40]",0.0005,0.002,0.0015,1
1690,0.015239999999998765,0.5128205128205128,3,9,27,39,33,6,8,17,20,2,0.1,"[0, 20, 40]",0.0005,0.002,0.0015,3
1691,0.02543999999999766,0.5409836065573771,5,12,44,61,55,6,8,17,20,2,0.1,"[0, 20, 40]",0.0005,0.002,0.0015,5
1692,0.006520000000000009,0.6111111111111112,6,5,7,18,17,1,8,17,20,2,0.2,"[0, 20, 40]",0.0003,0.001,0.001,1
1693,0.011790000000000137,0.5675675675675675,7,12,18,37,34,3,8,17,20,2,0.2,"[0, 20, 40]",0.0003,0.001,0.001,3
1694,0.01763000000000038,0.6122448979591837,11,16,22,49,44,5,8,17,20,2,0.2,"[0, 20, 40]",0.0003,0.001,0.001,5
1695,0.006540000000000027,0.5555555555555556,6,4,8,18,17,1,8,17,20,2,0.2,"[0, 20, 40]",0.0003,0.001,0.0015,1
1696,0.011080000000000088,0.4864864864864865,7,9,21,37,34,3,8,17,20,2,0.2,"[0, 20, 40]",0.0003,0.001,0.0015,3
1697,0.018420000000000332,0.5510204081632653,12,12,25,49,44,5,8,17,20,2,0.2,"[0, 20, 40]",0.0003,0.001,0.0015,5
1698,0.007249999999999851,0.6111111111111112,3,6,9,18,17,1,8,17,20,2,0.2,"[0, 20, 40]",0.0003,0.0015,0.001,1
1699,0.011859999999999933,0.5675675675675675,2,14,21,37,34,3,8,17,20,2,0.2,"[0, 20, 40]",0.0003,0.0015,0.001,3
1700,0.01820000000000012,0.6122448979591837,4,19,26,49,44,5,8,17,20,2,0.2,"[0, 20, 40]",0.0003,0.0015,0.001,5
1701,0.007769999999999868,0.5555555555555556,4,4,10,18,17,1,8,17,20,2,0.2,"[0, 20, 40]",0.0003,0.0015,0.0015,1
1702,0.01214999999999988,0.4864864864864865,3,10,24,37,34,3,8,17,20,2,0.2,"[0, 20, 40]",0.0003,0.0015,0.0015,3
1703,0.018929999999999947,0.5306122448979592,6,13,30,49,44,5,8,17,20,2,0.2,"[0, 20, 40]",0.0003,0.0015,0.0015,5
1704,0.00818999999999974,0.6111111111111112,2,6,10,18,17,1,8,17,20,2,0.2,"[0, 20, 40]",0.0003,0.002,0.001,1
1705,0.01229999999999982,0.5675675675675675,1,14,22,37,34,3,8,17,20,2,0.2,"[0, 20, 40]",0.0003,0.002,0.001,3
1706,0.018590000000000013,0.6122448979591837,2,19,28,49,44,5,8,17,20,2,0.2,"[0, 20, 40]",0.0003,0.002,0.001,5
1707,0.009209999999999755,0.5555555555555556,3,4,11,18,17,1,8,17,20,2,0.2,"[0, 20, 40]",0.0003,0.002,0.0015,1
1708,0.013089999999999765,0.4864864864864865,2,10,25,37,34,3,8,17,20,2,0.2,"[0, 20, 40]",0.0003,0.002,0.0015,3
1709,0.020319999999999845,0.5306122448979592,4,13,32,49,44,5,8,17,20,2,0.2,"[0, 20, 40]",0.0003,0.002,0.0015,5
1710,0.0030899999999999235,0.8,1,3,1,5,5,0,8,17,20,2,0.2,"[0, 20, 40]",0.0005,0.001,0.001,1
1711,0.009019999999999934,0.6842105263157895,3,8,8,19,18,1,8,17,20,2,0.2,"[0, 20, 40]",0.0005,0.001,0.001,3
1712,0.016269999999999996,0.6857142857142857,9,12,14,35,34,1,8,17,20,2,0.2,"[0, 20, 40]",0.0005,0.001,0.001,5
1713,0.0023099999999999206,0.6,1,2,2,5,5,0,8,17,20,2,0.2,"[0, 20, 40]",0.0005,0.001,0.0015,1
1714,0.007059999999999915,0.5263157894736842,3,5,11,19,18,1,8,17,20,2,0.2,"[0, 20, 40]",0.0005,0.001,0.0015,3
1715,0.01404999999999988,0.5714285714285714,9,8,18,35,34,1,8,17,20,2,0.2,"[0, 20, 40]",0.0005,0.001,0.0015,5
1716,0.00291999999999981,0.8,0,3,2,5,5,0,8,17,20,2,0.2,"[0, 20, 40]",0.0005,0.0015,0.001,1
1717,0.009229999999999811,0.6842105263157895,1,8,10,19,18,1,8,17,20,2,0.2,"[0, 20, 40]",0.0005,0.0015,0.001,3
1718,0.01797999999999955,0.6857142857142857,4,12,19,35,34,1,8,17,20,2,0.2,"[0, 20, 40]",0.0005,0.0015,0.001,5
1719,0.002139999999999807,0.6,0,2,3,5,5,0,8,17,20,2,0.2,"[0, 20, 40]",0.0005,0.0015,0.0015,1
1720,0.007269999999999793,0.5263157894736842,1,5,13,19,18,1,8,17,20,2,0.2,"[0, 20, 40]",0.0005,0.0015,0.0015,3
1721,0.015759999999999424,0.5714285714285714,4,8,23,35,34,1,8,17,20,2,0.2,"[0, 20, 40]",0.0005,0.0015,0.0015,5
1722,0.00291999999999981,0.8,0,3,2,5,5,0,8,17,20,2,0.2,"[0, 20, 40]",0.0005,0.002,0.001,1
1723,0.009729999999999812,0.6842105263157895,1,8,10,19,18,1,8,17,20,2,0.2,"[0, 20, 40]",0.0005,0.002,0.001,3
1724,0.018359999999999148,0.6857142857142857,2,12,21,35,34,1,8,17,20,2,0.2,"[0, 20, 40]",0.0005,0.002,0.001,5
1725,0.002139999999999807,0.6,0,2,3,5,5,0,8,17,20,2,0.2,"[0, 20, 40]",0.0005,0.002,0.0015,1
1726,0.007769999999999793,0.5263157894736842,1,5,13,19,18,1,8,17,20,2,0.2,"[0, 20, 40]",0.0005,0.002,0.0015,3
1727,0.01613999999999903,0.5714285714285714,2,8,25,35,34,1,8,17,20,2,0.2,"[0, 20, 40]",0.0005,0.002,0.0015,5
1728,0.006059999999998644,0.38235294117647056,5,6,23,34,20,14,9,15,5,1,0.1,"[0, 20, 40]",0.0003,0.001,0.001,1
1729,-0.0003400000000026499,0.2753623188405797,6,8,55,69,42,27,9,15,5,1,0.1,"[0, 20, 40]",0.0003,0.001,0.001,3
1730,-0.002530000000003721,0.2441860465116279,6,9,71,86,56,30,9,15,5,1,0.1,"[0, 20, 40]",0.0003,0.001,0.001,5
1731,0.002439999999998516,0.29411764705882354,5,3,26,34,20,14,9,15,5,1,0.1,"[0, 20, 40]",0.0003,0.001,0.0015,1
1732,-0.007950000000002932,0.2028985507246377,6,3,60,69,42,27,9,15,5,1,0.1,"[0, 20, 40]",0.0003,0.001,0.0015,3
1733,-0.010140000000004002,0.18604651162790697,7,3,76,86,56,30,9,15,5,1,0.1,"[0, 20, 40]",0.0003,0.001,0.0015,5
1734,0.004769999999998412,0.35294117647058826,0,7,27,34,20,14,9,15,5,1,0.1,"[0, 20, 40]",0.0003,0.0015,0.001,1
1735,-0.001560000000002977,0.2608695652173913,0,9,60,69,42,27,9,15,5,1,0.1,"[0, 20, 40]",0.0003,0.0015,0.001,3
1736,-0.003750000000004049,0.23255813953488372,0,10,76,86,56,30,9,15,5,1,0.1,"[0, 20, 40]",0.0003,0.0015,0.001,5
1737,-0.0003700000000015696,0.23529411764705882,0,3,31,34,20,14,9,15,5,1,0.1,"[0, 20, 40]",0.0003,0.0015,0.0015,1
1738,-0.010690000000003115,0.17391304347826086,0,3,66,69,42,27,9,15,5,1,0.1,"[0, 20, 40]",0.0003,0.0015,0.0015,3
1739,-0.012780000000004307,0.16279069767441862,0,3,83,86,56,30,9,15,5,1,0.1,"[0, 20, 40]",0.0003,0.0015,0.0015,5
1740,0.004769999999998412,0.35294117647058826,0,7,27,34,20,14,9,15,5,1,0.1,"[0, 20, 40]",0.0003,0.002,0.001,1
1741,-0.001560000000002977,0.2608695652173913,0,9,60,69,42,27,9,15,5,1,0.1,"[0, 20, 40]",0.0003,0.002,0.001,3
1742,-0.003750000000004049,0.23255813953488372,0,10,76,86,56,30,9,15,5,1,0.1,"[0, 20, 40]",0.0003,0.002,0.001,5
1743,-0.0003700000000015696,0.23529411764705882,0,3,31,34,20,14,9,15,5,1,0.1,"[0, 20, 40]",0.0003,0.002,0.0015,1
1744,-0.010690000000003115,0.17391304347826086,0,3,66,69,42,27,9,15,5,1,0.1,"[0, 20, 40]",0.0003,0.002,0.0015,3
1745,-0.012780000000004307,0.16279069767441862,0,3,83,86,56,30,9,15,5,1,0.1,"[0, 20, 40]",0.0003,0.002,0.0015,5
1746,0.0016799999999995256,0.7142857142857143,1,1,5,7,4,3,9,15,5,1,0.1,"[0, 20, 40]",0.0005,0.001,0.001,1
1747,0.004969999999998563,0.5161290322580645,5,5,21,31,20,11,9,15,5,1,0.1,"[0, 20, 40]",0.0005,0.001,0.001,3
1748,0.00255999999999745,0.4666666666666667,6,5,34,45,33,12,9,15,5,1,0.1,"[0, 20, 40]",0.0005,0.001,0.001,5
1749,-0.0006000000000006442,0.5714285714285714,1,0,6,7,4,3,9,15,5,1,0.1,"[0, 20, 40]",0.0005,0.001,0.0015,1
1750,-0.005180000000001871,0.3548387096774194,5,0,26,31,20,11,9,15,5,1,0.1,"[0, 20, 40]",0.0005,0.001,0.0015,3
1751,-0.007590000000002978,0.35555555555555557,6,0,39,45,33,12,9,15,5,1,0.1,"[0, 20, 40]",0.0005,0.001,0.0015,5
1752,0.0007099999999995003,0.5714285714285714,0,1,6,7,4,3,9,15,5,1,0.1,"[0, 20, 40]",0.0005,0.0015,0.001,1
1753,0.0033799999999984186,0.45161290322580644,1,5,25,31,20,11,9,15,5,1,0.1,"[0, 20, 40]",0.0005,0.0015,0.001,3
1754,0.0012699999999971623,0.4222222222222222,1,5,39,45,33,12,9,15,5,1,0.1,"[0, 20, 40]",0.0005,0.0015,0.001,5
1755,-0.0015700000000006698,0.42857142857142855,0,0,7,7,4,3,9,15,5,1,0.1,"[0, 20, 40]",0.0005,0.0015,0.0015,1
1756,-0.006770000000002014,0.2903225806451613,1,0,30,31,20,11,9,15,5,1,0.1,"[0, 20, 40]",0.0005,0.0015,0.0015,3
1757,-0.008880000000003267,0.3111111111111111,1,0,44,45,33,12,9,15,5,1,0.1,"[0, 20, 40]",0.0005,0.0015,0.0015,5
1758,0.0007099999999995003,0.5714285714285714,0,1,6,7,4,3,9,15,5,1,0.1,"[0, 20, 40]",0.0005,0.002,0.001,1
1759,0.003639999999998402,0.45161290322580644,0,5,26,31,20,11,9,15,5,1,0.1,"[0, 20, 40]",0.0005,0.002,0.001,3
1760,0.0015299999999971465,0.4222222222222222,0,5,40,45,33,12,9,15,5,1,0.1,"[0, 20, 40]",0.0005,0.002,0.001,5
1761,-0.0015700000000006698,0.42857142857142855,0,0,7,7,4,3,9,15,5,1,0.1,"[0, 20, 40]",0.0005,0.002,0.0015,1
1762,-0.00651000000000203,0.2903225806451613,0,0,31,31,20,11,9,15,5,1,0.1,"[0, 20, 40]",0.0005,0.002,0.0015,3
1763,-0.008620000000003283,0.3111111111111111,0,0,45,45,33,12,9,15,5,1,0.1,"[0, 20, 40]",0.0005,0.002,0.0015,5
1764,0.004999999999999515,0.47058823529411764,3,3,11,17,14,3,9,15,5,1,0.2,"[0, 20, 40]",0.0003,0.001,0.001,1
1765,0.00014999999999927246,0.34375,3,4,25,32,25,7,9,15,5,1,0.2,"[0, 20, 40]",0.0003,0.001,0.001,3
1766,-0.001860000000000972,0.275,3,4,33,40,32,8,9,15,5,1,0.2,"[0, 20, 40]",0.0003,0.001,0.001,5
1767,0.00423999999999942,0.4117647058823529,3,2,12,17,14,3,9,15,5,1,0.2,"[0, 20, 40]",0.0003,0.001,0.0015,1
1768,-0.0023900000000008255,0.28125,3,2,27,32,25,7,9,15,5,1,0.2,"[0, 20, 40]",0.0003,0.001,0.0015,3
1769,-0.004400000000001067,0.225,3,2,35,40,32,8,9,15,5,1,0.2,"[0, 20, 40]",0.0003,0.001,0.0015,5
1770,0.003649999999999443,0.4117647058823529,0,3,14,17,14,3,9,15,5,1,0.2,"[0, 20, 40]",0.0003,0.0015,0.001,1
1771,-0.0012000000000007983,0.3125,0,4,28,32,25,7,9,15,5,1,0.2,"[0, 20, 40]",0.0003,0.0015,0.001,3
1772,-0.003210000000001043,0.25,0,4,36,40,32,8,9,15,5,1,0.2,"[0, 20, 40]",0.0003,0.0015,0.001,5
1773,0.0028899999999993475,0.35294117647058826,0,2,15,17,14,3,9,15,5,1,0.2,"[0, 20, 40]",0.0003,0.0015,0.0015,1
1774,-0.0037400000000008963,0.25,0,2,30,32,25,7,9,15,5,1,0.2,"[0, 20, 40]",0.0003,0.0015,0.0015,3
1775,-0.005750000000001138,0.2,0,2,38,40,32,8,9,15,5,1,0.2,"[0, 20, 40]",0.0003,0.0015,0.0015,5
1776,0.003649999999999443,0.4117647058823529,0,3,14,17,14,3,9,15,5,1,0.2,"[0, 20, 40]",0.0003,0.002,0.001,1
1777,-0.0012000000000007983,0.3125,0,4,28,32,25,7,9,15,5,1,0.2,"[0, 20, 40]",0.0003,0.002,0.001,3
1778,-0.003210000000001043,0.25,0,4,36,40,32,8,9,15,5,1,0.2,"[0, 20, 40]",0.0003,0.002,0.001,5
1779,0.0028899999999993475,0.35294117647058826,0,2,15,17,14,3,9,15,5,1,0.2,"[0, 20, 40]",0.0003,0.002,0.0015,1
1780,-0.0037400000000008963,0.25,0,2,30,32,25,7,9,15,5,1,0.2,"[0, 20, 40]",0.0003,0.002,0.0015,3
1781,-0.005750000000001138,0.2,0,2,38,40,32,8,9,15,5,1,0.2,"[0, 20, 40]",0.0003,0.002,0.0015,5
1782,0.0017999999999995797,0.8,0,1,4,5,4,1,9,15,5,1,0.2,"[0, 20, 40]",0.0005,0.001,0.001,1
1783,0.0008799999999990142,0.42105263157894735,2,3,14,19,16,3,9,15,5,1,0.2,"[0, 20, 40]",0.0005,0.001,0.001,3
1784,-0.000800000000001444,0.375,2,3,19,24,21,3,9,15,5,1,0.2,"[0, 20, 40]",0.0005,0.001,0.001,5
1785,-0.0004800000000005905,0.6,0,0,5,5,4,1,9,15,5,1,0.2,"[0, 20, 40]",0.0005,0.001,0.0015,1
1786,-0.005460000000001325,0.2631578947368421,2,0,17,19,16,3,9,15,5,1,0.2,"[0, 20, 40]",0.0005,0.001,0.0015,3
1787,-0.0071400000000017855,0.25,2,0,22,24,21,3,9,15,5,1,0.2,"[0, 20, 40]",0.0005,0.001,0.0015,5
1788,0.0017999999999995797,0.8,0,1,4,5,4,1,9,15,5,1,0.2,"[0, 20, 40]",0.0005,0.0015,0.001,1
1789,0.0005999999999989006,0.3684210526315789,1,3,15,19,16,3,9,15,5,1,0.2,"[0, 20, 40]",0.0005,0.0015,0.001,3
1790,-0.0010800000000015571,0.3333333333333333,1,3,20,24,21,3,9,15,5,1,0.2,"[0, 20, 40]",0.0005,0.0015,0.001,5
1791,-0.0004800000000005905,0.6,0,0,5,5,4,1,9,15,5,1,0.2,"[0, 20, 40]",0.0005,0.0015,0.0015,1
1792,-0.005740000000001439,0.21052631578947367,1,0,18,19,16,3,9,15,5,1,0.2,"[0, 20, 40]",0.0005,0.0015,0.0015,3
1793,-0.007420000000001897,0.20833333333333334,1,0,23,24,21,3,9,15,5,1,0.2,"[0, 20, 40]",0.0005,0.0015,0.0015,5
1794,0.0017999999999995797,0.8,0,1,4,5,4,1,9,15,5,1,0.2,"[0, 20, 40]",0.0005,0.002,0.001,1
1795,0.0008599999999988843,0.3684210526315789,0,3,16,19,16,3,9,15,5,1,0.2,"[0, 20, 40]",0.0005,0.002,0.001,3
1796,-0.0008200000000015732,0.3333333333333333,0,3,21,24,21,3,9,15,5,1,0.2,"[0, 20, 40]",0.0005,0.002,0.001,5
1797,-0.0004800000000005905,0.6,0,0,5,5,4,1,9,15,5,1,0.2,"[0, 20, 40]",0.0005,0.002,0.0015,1
1798,-0.005480000000001456,0.21052631578947367,0,0,19,19,16,3,9,15,5,1,0.2,"[0, 20, 40]",0.0005,0.002,0.0015,3
1799,-0.007160000000001913,0.20833333333333334,0,0,24,24,21,3,9,15,5,1,0.2,"[0, 20, 40]",0.0005,0.002,0.0015,5
1800,0.0008899999999992138,0.2608695652173913,3,2,18,23,15,8,9,15,5,2,0.1,"[0, 20, 40]",0.0003,0.001,0.001,1
1801,-0.004560000000002381,0.21153846153846154,4,4,44,52,36,16,9,15,5,2,0.1,"[0, 20, 40]",0.0003,0.001,0.001,3
1802,-0.005720000000003263,0.2,4,5,56,65,48,17,9,15,5,2,0.1,"[0, 20, 40]",0.0003,0.001,0.001,5
1803,0.0018899999999992126,0.2608695652173913,3,2,18,23,15,8,9,15,5,2,0.1,"[0, 20, 40]",0.0003,0.001,0.0015,1
1804,-0.0075500000000025425,0.17307692307692307,4,2,46,52,36,16,9,15,5,2,0.1,"[0, 20, 40]",0.0003,0.001,0.0015,3
1805,-0.008710000000003435,0.16923076923076924,5,2,58,65,48,17,9,15,5,2,0.1,"[0, 20, 40]",0.0003,0.001,0.0015,5
1806,-0.000900000000000853,0.21739130434782608,0,2,21,23,15,8,9,15,5,2,0.1,"[0, 20, 40]",0.0003,0.0015,0.001,1
1807,-0.006280000000002541,0.19230769230769232,0,4,48,52,36,16,9,15,5,2,0.1,"[0, 20, 40]",0.0003,0.0015,0.001,3
1808,-0.007440000000003426,0.18461538461538463,0,5,60,65,48,17,9,15,5,2,0.1,"[0, 20, 40]",0.0003,0.0015,0.001,5
1809,9.999999999914634e-05,0.21739130434782608,0,2,21,23,15,8,9,15,5,2,0.1,"[0, 20, 40]",0.0003,0.0015,0.0015,1
1810,-0.009270000000002707,0.15384615384615385,0,2,50,52,36,16,9,15,5,2,0.1,"[0, 20, 40]",0.0003,0.0015,0.0015,3
1811,-0.010330000000003722,0.15384615384615385,0,2,63,65,48,17,9,15,5,2,0.1,"[0, 20, 40]",0.0003,0.0015,0.0015,5
1812,-0.000900000000000853,0.21739130434782608,0,2,21,23,15,8,9,15,5,2,0.1,"[0, 20, 40]",0.0003,0.002,0.001,1
1813,-0.006280000000002541,0.19230769230769232,0,4,48,52,36,16,9,15,5,2,0.1,"[0, 20, 40]",0.0003,0.002,0.001,3
1814,-0.007440000000003426,0.18461538461538463,0,5,60,65,48,17,9,15,5,2,0.1,"[0, 20, 40]",0.0003,0.002,0.001,5
1815,9.999999999914634e-05,0.21739130434782608,0,2,21,23,15,8,9,15,5,2,0.1,"[0, 20, 40]",0.0003,0.002,0.0015,1
1816,-0.009270000000002707,0.15384615384615385,0,2,50,52,36,16,9,15,5,2,0.1,"[0, 20, 40]",0.0003,0.002,0.0015,3
1817,-0.010330000000003722,0.15384615384615385,0,2,63,65,48,17,9,15,5,2,0.1,"[0, 20, 40]",0.0003,0.002,0.0015,5
1818,0.00174999999999974,0.625,1,1,6,8,6,2,9,15,5,2,0.1,"[0, 20, 40]",0.0005,0.001,0.001,1
1819,0.002619999999999175,0.48,3,4,18,25,20,5,9,15,5,2,0.1,"[0, 20, 40]",0.0005,0.001,0.001,3
1820,0.002309999999998566,0.4722222222222222,4,4,28,36,31,5,9,15,5,2,0.1,"[0, 20, 40]",0.0005,0.001,0.001,5
1821,-0.0005300000000004295,0.5,1,0,7,8,6,2,9,15,5,2,0.1,"[0, 20, 40]",0.0005,0.001,0.0015,1
1822,-0.005730000000001341,0.32,3,0,22,25,20,5,9,15,5,2,0.1,"[0, 20, 40]",0.0005,0.001,0.0015,3
1823,-0.006040000000001951,0.3611111111111111,4,0,32,36,31,5,9,15,5,2,0.1,"[0, 20, 40]",0.0005,0.001,0.0015,5
1824,0.0007799999999997148,0.5,0,1,7,8,6,2,9,15,5,2,0.1,"[0, 20, 40]",0.0005,0.0015,0.001,1
1825,0.0010099999999989562,0.4,0,4,21,25,20,5,9,15,5,2,0.1,"[0, 20, 40]",0.0005,0.0015,0.001,3
1826,0.0009999999999982033,0.4166666666666667,0,4,32,36,31,5,9,15,5,2,0.1,"[0, 20, 40]",0.0005,0.0015,0.001,5
1827,-0.0015000000000004554,0.375,0,0,8,8,6,2,9,15,5,2,0.1,"[0, 20, 40]",0.0005,0.0015,0.0015,1
1828,-0.007340000000001562,0.24,0,0,25,25,20,5,9,15,5,2,0.1,"[0, 20, 40]",0.0005,0.0015,0.0015,3
1829,-0.007350000000002313,0.3055555555555556,0,0,36,36,31,5,9,15,5,2,0.1,"[0, 20, 40]",0.0005,0.0015,0.0015,5
1830,0.0007799999999997148,0.5,0,1,7,8,6,2,9,15,5,2,0.1,"[0, 20, 40]",0.0005,0.002,0.001,1
1831,0.0010099999999989562,0.4,0,4,21,25,20,5,9,15,5,2,0.1,"[0, 20, 40]",0.0005,0.002,0.001,3
1832,0.0009999999999982033,0.4166666666666667,0,4,32,36,31,5,9,15,5,2,0.1,"[0, 20, 40]",0.0005,0.002,0.001,5
1833,-0.0015000000000004554,0.375,0,0,8,8,6,2,9,15,5,2,0.1,"[0, 20, 40]",0.0005,0.002,0.0015,1
1834,-0.007340000000001562,0.24,0,0,25,25,20,5,9,15,5,2,0.1,"[0, 20, 40]",0.0005,0.002,0.0015,3
1835,-0.007350000000002313,0.3055555555555556,0,0,36,36,31,5,9,15,5,2,0.1,"[0, 20, 40]",0.0005,0.002,0.0015,5
1836,0.0027199999999996975,0.45454545454545453,3,2,6,11,10,1,9,15,5,2,0.2,"[0, 20, 40]",0.0003,0.001,0.001,1
1837,-0.0009100000000009451,0.2916666666666667,3,3,18,24,20,4,9,15,5,2,0.2,"[0, 20, 40]",0.0003,0.001,0.001,3
1838,-0.0012700000000011279,0.25806451612903225,3,4,24,31,26,5,9,15,5,2,0.2,"[0, 20, 40]",0.0003,0.001,0.001,5
1839,0.003719999999999697,0.45454545454545453,3,2,6,11,10,1,9,15,5,2,0.2,"[0, 20, 40]",0.0003,0.001,0.0015,1
1840,-0.0016900000000009481,0.25,3,2,19,24,20,4,9,15,5,2,0.2,"[0, 20, 40]",0.0003,0.001,0.0015,3
1841,-0.0020500000000011308,0.22580645161290322,4,2,25,31,26,5,9,15,5,2,0.2,"[0, 20, 40]",0.0003,0.001,0.0015,5
1842,0.0009299999999996309,0.36363636363636365,0,2,9,11,10,1,9,15,5,2,0.2,"[0, 20, 40]",0.0003,0.0015,0.001,1
1843,-0.002700000000001012,0.25,0,3,21,24,20,4,9,15,5,2,0.2,"[0, 20, 40]",0.0003,0.0015,0.001,3
1844,-0.003060000000001195,0.22580645161290322,0,4,27,31,26,5,9,15,5,2,0.2,"[0, 20, 40]",0.0003,0.0015,0.001,5
1845,0.0019299999999996304,0.36363636363636365,0,2,9,11,10,1,9,15,5,2,0.2,"[0, 20, 40]",0.0003,0.0015,0.0015,1
1846,-0.003480000000001015,0.20833333333333334,0,2,22,24,20,4,9,15,5,2,0.2,"[0, 20, 40]",0.0003,0.0015,0.0015,3
1847,-0.003740000000001319,0.1935483870967742,0,2,29,31,26,5,9,15,5,2,0.2,"[0, 20, 40]",0.0003,0.0015,0.0015,5
1848,0.0009299999999996309,0.36363636363636365,0,2,9,11,10,1,9,15,5,2,0.2,"[0, 20, 40]",0.0003,0.002,0.001,1
1849,-0.002700000000001012,0.25,0,3,21,24,20,4,9,15,5,2,0.2,"[0, 20, 40]",0.0003,0.002,0.001,3
1850,-0.003060000000001195,0.22580645161290322,0,4,27,31,26,5,9,15,5,2,0.2,"[0, 20, 40]",0.0003,0.002,0.001,5
1851,0.0019299999999996304,0.36363636363636365,0,2,9,11,10,1,9,15,5,2,0.2,"[0, 20, 40]",0.0003,0.002,0.0015,1
1852,-0.003480000000001015,0.20833333333333334,0,2,22,24,20,4,9,15,5,2,0.2,"[0, 20, 40]",0.0003,0.002,0.0015,3
1853,-0.003740000000001319,0.1935483870967742,0,2,29,31,26,5,9,15,5,2,0.2,"[0, 20, 40]",0.0003,0.002,0.0015,5
1854,0.0005699999999997595,0.5,0,1,3,4,4,0,9,15,5,2,0.2,"[0, 20, 40]",0.0005,0.001,0.001,1
1855,0.0012699999999994586,0.42857142857142855,2,3,9,14,13,1,9,15,5,2,0.2,"[0, 20, 40]",0.0005,0.001,0.001,3
1856,0.0017199999999990537,0.45,3,3,14,20,19,1,9,15,5,2,0.2,"[0, 20, 40]",0.0005,0.001,0.001,5
1857,-0.0017100000000004108,0.25,0,0,4,4,4,0,9,15,5,2,0.2,"[0, 20, 40]",0.0005,0.001,0.0015,1
1858,-0.005070000000000883,0.21428571428571427,2,0,12,14,13,1,9,15,5,2,0.2,"[0, 20, 40]",0.0005,0.001,0.0015,3
1859,-0.004620000000001288,0.3,3,0,17,20,19,1,9,15,5,2,0.2,"[0, 20, 40]",0.0005,0.001,0.0015,5
1860,0.0005699999999997595,0.5,0,1,3,4,4,0,9,15,5,2,0.2,"[0, 20, 40]",0.0005,0.0015,0.001,1
1861,0.0006299999999992642,0.35714285714285715,0,3,11,14,13,1,9,15,5,2,0.2,"[0, 20, 40]",0.0005,0.0015,0.001,3
1862,0.0013799999999987156,0.4,0,3,17,20,19,1,9,15,5,2,0.2,"[0, 20, 40]",0.0005,0.0015,0.001,5
1863,-0.0017100000000004108,0.25,0,0,4,4,4,0,9,15,5,2,0.2,"[0, 20, 40]",0.0005,0.0015,0.0015,1
1864,-0.005710000000001077,0.14285714285714285,0,0,14,14,13,1,9,15,5,2,0.2,"[0, 20, 40]",0.0005,0.0015,0.0015,3
1865,-0.004960000000001626,0.25,0,0,20,20,19,1,9,15,5,2,0.2,"[0, 20, 40]",0.0005,0.0015,0.0015,5
1866,0.0005699999999997595,0.5,0,1,3,4,4,0,9,15,5,2,0.2,"[0, 20, 40]",0.0005,0.002,0.001,1
1867,0.0006299999999992642,0.35714285714285715,0,3,11,14,13,1,9,15,5,2,0.2,"[0, 20, 40]",0.0005,0.002,0.001,3
1868,0.0013799999999987156,0.4,0,3,17,20,19,1,9,15,5,2,0.2,"[0, 20, 40]",0.0005,0.002,0.001,5
1869,-0.0017100000000004108,0.25,0,0,4,4,4,0,9,15,5,2,0.2,"[0, 20, 40]",0.0005,0.002,0.0015,1
1870,-0.005710000000001077,0.14285714285714285,0,0,14,14,13,1,9,15,5,2,0.2,"[0, 20, 40]",0.0005,0.002,0.0015,3
1871,-0.004960000000001626,0.25,0,0,20,20,19,1,9,15,5,2,0.2,"[0, 20, 40]",0.0005,0.002,0.0015,5
1872,0.008509999999998593,0.5294117647058824,8,6,20,34,20,14,9,15,10,1,0.1,"[0, 20, 40]",0.0003,0.001,0.001,1
1873,0.007379999999998382,0.44285714285714284,14,12,44,70,43,27,9,15,10,1,0.1,"[0, 20, 40]",0.0003,0.001,0.001,3
1874,0.013319999999997917,0.4772727272727273,17,16,55,88,58,30,9,15,10,1,0.1,"[0, 20, 40]",0.0003,0.001,0.001,5
1875,0.006059999999998587,0.4411764705882353,8,3,23,34,20,14,9,15,10,1,0.1,"[0, 20, 40]",0.0003,0.001,0.0015,1
1876,0.0035199999999982376,0.37142857142857144,14,7,49,70,43,27,9,15,10,1,0.1,"[0, 20, 40]",0.0003,0.001,0.0015,3
1877,0.006559999999997716,0.3977272727272727,18,8,62,88,58,30,9,15,10,1,0.1,"[0, 20, 40]",0.0003,0.001,0.0015,5
1878,0.010109999999998634,0.5294117647058824,4,8,22,34,20,14,9,15,10,1,0.1,"[0, 20, 40]",0.0003,0.0015,0.001,1
1879,0.00841999999999809,0.44285714285714284,4,14,52,70,43,27,9,15,10,1,0.1,"[0, 20, 40]",0.0003,0.0015,0.001,3
1880,0.012919999999997189,0.4659090909090909,4,18,66,88,58,30,9,15,10,1,0.1,"[0, 20, 40]",0.0003,0.0015,0.001,5
1881,0.007479999999998506,0.4117647058823529,5,3,26,34,20,14,9,15,10,1,0.1,"[0, 20, 40]",0.0003,0.0015,0.0015,1
1882,0.004379999999997829,0.35714285714285715,5,7,58,70,43,27,9,15,10,1,0.1,"[0, 20, 40]",0.0003,0.0015,0.0015,3
1883,0.006239999999996682,0.375,5,8,75,88,58,30,9,15,10,1,0.1,"[0, 20, 40]",0.0003,0.0015,0.0015,5
1884,0.009779999999998474,0.5294117647058824,2,8,24,34,20,14,9,15,10,1,0.1,"[0, 20, 40]",0.0003,0.002,0.001,1
1885,0.00808999999999793,0.44285714285714284,2,14,54,70,43,27,9,15,10,1,0.1,"[0, 20, 40]",0.0003,0.002,0.001,3
1886,0.012589999999997029,0.4659090909090909,2,18,68,88,58,30,9,15,10,1,0.1,"[0, 20, 40]",0.0003,0.002,0.001,5
1887,0.007479999999998345,0.4117647058823529,2,3,29,34,20,14,9,15,10,1,0.1,"[0, 20, 40]",0.0003,0.002,0.0015,1
1888,0.004379999999997664,0.35714285714285715,2,7,61,70,43,27,9,15,10,1,0.1,"[0, 20, 40]",0.0003,0.002,0.0015,3
1889,0.006239999999996518,0.375,2,8,78,88,58,30,9,15,10,1,0.1,"[0, 20, 40]",0.0003,0.002,0.0015,5
1890,0.004359999999999872,0.8571428571428571,3,2,2,7,4,3,9,15,10,1,0.1,"[0, 20, 40]",0.0005,0.001,0.001,1
1891,0.00986999999999966,0.59375,9,8,15,32,21,11,9,15,10,1,0.1,"[0, 20, 40]",0.0005,0.001,0.001,3
1892,0.01407999999999882,0.5957446808510638,14,10,23,47,35,12,9,15,10,1,0.1,"[0, 20, 40]",0.0005,0.001,0.001,5
1893,0.003979999999999992,0.7142857142857143,3,1,3,7,4,3,9,15,10,1,0.1,"[0, 20, 40]",0.0005,0.001,0.0015,1
1894,0.008279999999999623,0.5,9,5,18,32,21,11,9,15,10,1,0.1,"[0, 20, 40]",0.0005,0.001,0.0015,3
1895,0.01154999999999856,0.5106382978723404,14,6,27,47,35,12,9,15,10,1,0.1,"[0, 20, 40]",0.0005,0.001,0.0015,5
1896,0.003129999999999642,0.5714285714285714,1,2,4,7,4,3,9,15,10,1,0.1,"[0, 20, 40]",0.0005,0.0015,0.001,1
1897,0.0103399999999993,0.53125,4,8,20,32,21,11,9,15,10,1,0.1,"[0, 20, 40]",0.0005,0.0015,0.001,3
1898,0.016139999999997774,0.5531914893617021,6,10,31,47,35,12,9,15,10,1,0.1,"[0, 20, 40]",0.0005,0.0015,0.001,5
1899,0.002749999999999762,0.42857142857142855,1,1,5,7,4,3,9,15,10,1,0.1,"[0, 20, 40]",0.0005,0.0015,0.0015,1
1900,0.00874999999999926,0.4375,4,5,23,32,21,11,9,15,10,1,0.1,"[0, 20, 40]",0.0005,0.0015,0.0015,3
1901,0.01360999999999751,0.46808510638297873,6,6,35,47,35,12,9,15,10,1,0.1,"[0, 20, 40]",0.0005,0.0015,0.0015,5
1902,0.003629999999999642,0.5714285714285714,1,2,4,7,4,3,9,15,10,1,0.1,"[0, 20, 40]",0.0005,0.002,0.001,1
1903,0.010659999999999174,0.5,3,8,21,32,21,11,9,15,10,1,0.1,"[0, 20, 40]",0.0005,0.002,0.001,3
1904,0.01649999999999758,0.5319148936170213,4,10,33,47,35,12,9,15,10,1,0.1,"[0, 20, 40]",0.0005,0.002,0.001,5
1905,0.003249999999999762,0.42857142857142855,1,1,5,7,4,3,9,15,10,1,0.1,"[0, 20, 40]",0.0005,0.002,0.0015,1
1906,0.009069999999999138,0.40625,3,5,24,32,21,11,9,15,10,1,0.1,"[0, 20, 40]",0.0005,0.002,0.0015,3
1907,0.013969999999997314,0.44680851063829785,4,6,37,47,35,12,9,15,10,1,0.1,"[0, 20, 40]",0.0005,0.002,0.0015,5
1908,0.006299999999999704,0.6470588235294118,6,3,8,17,14,3,9,15,10,1,0.2,"[0, 20, 40]",0.0003,0.001,0.001,1
1909,0.0056599999999997295,0.5,8,6,18,32,25,7,9,15,10,1,0.2,"[0, 20, 40]",0.0003,0.001,0.001,3
1910,0.011559999999999427,0.5853658536585366,10,9,22,41,33,8,9,15,10,1,0.2,"[0, 20, 40]",0.0003,0.001,0.001,5
1911,0.006369999999999719,0.5882352941176471,6,2,9,17,14,3,9,15,10,1,0.2,"[0, 20, 40]",0.0003,0.001,0.0015,1
1912,0.00456999999999969,0.4375,8,4,20,32,25,7,9,15,10,1,0.2,"[0, 20, 40]",0.0003,0.001,0.0015,3
1913,0.007569999999999326,0.4878048780487805,10,5,26,41,33,8,9,15,10,1,0.2,"[0, 20, 40]",0.0003,0.001,0.0015,5
1914,0.007399999999999749,0.6470588235294118,3,4,10,17,14,3,9,15,10,1,0.2,"[0, 20, 40]",0.0003,0.0015,0.001,1
1915,0.006239999999999701,0.5,3,7,22,32,25,7,9,15,10,1,0.2,"[0, 20, 40]",0.0003,0.0015,0.001,3
1916,0.01065999999999903,0.5609756097560976,3,10,28,41,33,8,9,15,10,1,0.2,"[0, 20, 40]",0.0003,0.0015,0.001,5
1917,0.00678999999999964,0.5294117647058824,3,2,12,17,14,3,9,15,10,1,0.2,"[0, 20, 40]",0.0003,0.0015,0.0015,1
1918,0.004469999999999537,0.40625,3,4,25,32,25,7,9,15,10,1,0.2,"[0, 20, 40]",0.0003,0.0015,0.0015,3
1919,0.005989999999998807,0.43902439024390244,3,5,33,41,33,8,9,15,10,1,0.2,"[0, 20, 40]",0.0003,0.0015,0.0015,5
1920,0.006569999999999588,0.6470588235294118,1,4,12,17,14,3,9,15,10,1,0.2,"[0, 20, 40]",0.0003,0.002,0.001,1
1921,0.005409999999999537,0.5,1,7,24,32,25,7,9,15,10,1,0.2,"[0, 20, 40]",0.0003,0.002,0.001,3
1922,0.009829999999998871,0.5609756097560976,1,10,30,41,33,8,9,15,10,1,0.2,"[0, 20, 40]",0.0003,0.002,0.001,5
1923,0.005959999999999479,0.5294117647058824,1,2,14,17,14,3,9,15,10,1,0.2,"[0, 20, 40]",0.0003,0.002,0.0015,1
1924,0.003639999999999375,0.40625,1,4,27,32,25,7,9,15,10,1,0.2,"[0, 20, 40]",0.0003,0.002,0.0015,3
1925,0.005159999999998642,0.43902439024390244,1,5,35,41,33,8,9,15,10,1,0.2,"[0, 20, 40]",0.0003,0.002,0.0015,5
1926,0.002759999999999872,0.8,2,1,2,5,4,1,9,15,10,1,0.2,"[0, 20, 40]",0.0005,0.001,0.001,1
1927,0.004909999999999877,0.5789473684210527,5,4,10,19,16,3,9,15,10,1,0.2,"[0, 20, 40]",0.0005,0.001,0.001,3
1928,0.006879999999999439,0.6,6,6,13,25,22,3,9,15,10,1,0.2,"[0, 20, 40]",0.0005,0.001,0.001,5
1929,0.0032599999999998715,0.8,2,1,2,5,4,1,9,15,10,1,0.2,"[0, 20, 40]",0.0005,0.001,0.0015,1
1930,0.004409999999999766,0.5263157894736842,5,3,11,19,16,3,9,15,10,1,0.2,"[0, 20, 40]",0.0005,0.001,0.0015,3
1931,0.005439999999999106,0.52,6,4,15,25,22,3,9,15,10,1,0.2,"[0, 20, 40]",0.0005,0.001,0.0015,5
1932,0.002639999999999697,0.6,1,1,3,5,4,1,9,15,10,1,0.2,"[0, 20, 40]",0.0005,0.0015,0.001,1
1933,0.005249999999999663,0.5263157894736842,2,4,13,19,16,3,9,15,10,1,0.2,"[0, 20, 40]",0.0005,0.0015,0.001,3
1934,0.007099999999998995,0.56,2,6,17,25,22,3,9,15,10,1,0.2,"[0, 20, 40]",0.0005,0.0015,0.001,5
1935,0.0031399999999996964,0.6,1,1,3,5,4,1,9,15,10,1,0.2,"[0, 20, 40]",0.0005,0.0015,0.0015,1
1936,0.004749999999999552,0.47368421052631576,2,3,14,19,16,3,9,15,10,1,0.2,"[0, 20, 40]",0.0005,0.0015,0.0015,3
1937,0.005659999999998662,0.48,2,4,19,25,22,3,9,15,10,1,0.2,"[0, 20, 40]",0.0005,0.0015,0.0015,5
1938,0.003139999999999697,0.6,1,1,3,5,4,1,9,15,10,1,0.2,"[0, 20, 40]",0.0005,0.002,0.001,1
1939,0.004569999999999539,0.47368421052631576,1,4,14,19,16,3,9,15,10,1,0.2,"[0, 20, 40]",0.0005,0.002,0.001,3
1940,0.0064199999999988685,0.52,1,6,18,25,22,3,9,15,10,1,0.2,"[0, 20, 40]",0.0005,0.002,0.001,5
1941,0.0036399999999996964,0.6,1,1,3,5,4,1,9,15,10,1,0.2,"[0, 20, 40]",0.0005,0.002,0.0015,1
1942,0.0040699999999994265,0.42105263157894735,1,3,15,19,16,3,9,15,10,1,0.2,"[0, 20, 40]",0.0005,0.002,0.0015,3
1943,0.004979999999998538,0.44,1,4,20,25,22,3,9,15,10,1,0.2,"[0, 20, 40]",0.0005,0.002,0.0015,5
1944,0.002279999999998882,0.391304347826087,4,2,17,23,15,8,9,15,10,2,0.1,"[0, 20, 40]",0.0003,0.001,0.001,1
1945,0.004809999999998354,0.41509433962264153,10,8,35,53,37,16,9,15,10,2,0.1,"[0, 20, 40]",0.0003,0.001,0.001,3
1946,0.010859999999998038,0.47761194029850745,13,12,42,67,50,17,9,15,10,2,0.1,"[0, 20, 40]",0.0003,0.001,0.001,5
1947,0.003279999999998881,0.391304347826087,4,2,17,23,15,8,9,15,10,2,0.1,"[0, 20, 40]",0.0003,0.001,0.0015,1
1948,0.006149999999998305,0.39622641509433965,10,7,36,53,37,16,9,15,10,2,0.1,"[0, 20, 40]",0.0003,0.001,0.0015,3
1949,0.009299999999997921,0.43283582089552236,14,8,45,67,50,17,9,15,10,2,0.1,"[0, 20, 40]",0.0003,0.001,0.0015,5
1950,0.0027299999999989433,0.391304347826087,2,3,18,23,15,8,9,15,10,2,0.1,"[0, 20, 40]",0.0003,0.0015,0.001,1
1951,0.0051999999999982486,0.41509433962264153,2,9,42,53,37,16,9,15,10,2,0.1,"[0, 20, 40]",0.0003,0.0015,0.001,3
1952,0.009809999999997498,0.4626865671641791,2,13,52,67,50,17,9,15,10,2,0.1,"[0, 20, 40]",0.0003,0.0015,0.001,5
1953,0.0030499999999988184,0.34782608695652173,2,2,19,23,15,8,9,15,10,2,0.1,"[0, 20, 40]",0.0003,0.0015,0.0015,1
1954,0.005859999999998075,0.37735849056603776,2,7,44,53,37,16,9,15,10,2,0.1,"[0, 20, 40]",0.0003,0.0015,0.0015,3
1955,0.007829999999997072,0.40298507462686567,2,8,57,67,50,17,9,15,10,2,0.1,"[0, 20, 40]",0.0003,0.0015,0.0015,5
1956,0.003169999999999051,0.391304347826087,1,3,19,23,15,8,9,15,10,2,0.1,"[0, 20, 40]",0.0003,0.002,0.001,1
1957,0.005639999999998356,0.41509433962264153,1,9,43,53,37,16,9,15,10,2,0.1,"[0, 20, 40]",0.0003,0.002,0.001,3
1958,0.010249999999997607,0.4626865671641791,1,13,53,67,50,17,9,15,10,2,0.1,"[0, 20, 40]",0.0003,0.002,0.001,5
1959,0.0034899999999989263,0.34782608695652173,1,2,20,23,15,8,9,15,10,2,0.1,"[0, 20, 40]",0.0003,0.002,0.0015,1
1960,0.006299999999998184,0.37735849056603776,1,7,45,53,37,16,9,15,10,2,0.1,"[0, 20, 40]",0.0003,0.002,0.0015,3
1961,0.008269999999997179,0.40298507462686567,1,8,58,67,50,17,9,15,10,2,0.1,"[0, 20, 40]",0.0003,0.002,0.0015,5
1962,0.0027299999999999412,0.625,3,1,4,8,6,2,9,15,10,2,0.1,"[0, 20, 40]",0.0005,0.001,0.001,1
1963,0.008729999999999766,0.6153846153846154,7,7,12,26,21,5,9,15,10,2,0.1,"[0, 20, 40]",0.0005,0.001,0.001,3
1964,0.013889999999999217,0.631578947368421,12,9,17,38,33,5,9,15,10,2,0.1,"[0, 20, 40]",0.0005,0.001,0.001,5
1965,0.0032299999999999413,0.625,3,1,4,8,6,2,9,15,10,2,0.1,"[0, 20, 40]",0.0005,0.001,0.0015,1
1966,0.009729999999999649,0.5769230769230769,7,6,13,26,21,5,9,15,10,2,0.1,"[0, 20, 40]",0.0005,0.001,0.0015,3
1967,0.013949999999998887,0.5789473684210527,12,7,19,38,33,5,9,15,10,2,0.1,"[0, 20, 40]",0.0005,0.001,0.0015,5
1968,0.0014999999999997119,0.375,1,1,6,8,6,2,9,15,10,2,0.1,"[0, 20, 40]",0.0005,0.0015,0.001,1
1969,0.008199999999999406,0.5384615384615384,2,7,17,26,21,5,9,15,10,2,0.1,"[0, 20, 40]",0.0005,0.0015,0.001,3
1970,0.014949999999998168,0.5789473684210527,4,9,25,38,33,5,9,15,10,2,0.1,"[0, 20, 40]",0.0005,0.0015,0.001,5
1971,0.0019999999999997116,0.375,1,1,6,8,6,2,9,15,10,2,0.1,"[0, 20, 40]",0.0005,0.0015,0.0015,1
1972,0.00919999999999929,0.5,2,6,18,26,21,5,9,15,10,2,0.1,"[0, 20, 40]",0.0005,0.0015,0.0015,3
1973,0.015009999999997836,0.5263157894736842,4,7,27,38,33,5,9,15,10,2,0.1,"[0, 20, 40]",0.0005,0.0015,0.0015,5
1974,0.001999999999999712,0.375,1,1,6,8,6,2,9,15,10,2,0.1,"[0, 20, 40]",0.0005,0.002,0.001,1
1975,0.009199999999999407,0.5384615384615384,2,7,17,26,21,5,9,15,10,2,0.1,"[0, 20, 40]",0.0005,0.002,0.001,3
1976,0.0159899999999981,0.5789473684210527,3,9,26,38,33,5,9,15,10,2,0.1,"[0, 20, 40]",0.0005,0.002,0.001,5
1977,0.0024999999999997117,0.375,1,1,6,8,6,2,9,15,10,2,0.1,"[0, 20, 40]",0.0005,0.002,0.0015,1
1978,0.01019999999999929,0.5,2,6,18,26,21,5,9,15,10,2,0.1,"[0, 20, 40]",0.0005,0.002,0.0015,3
1979,0.01604999999999777,0.5263157894736842,3,7,28,38,33,5,9,15,10,2,0.1,"[0, 20, 40]",0.0005,0.002,0.0015,5
1980,0.0030999999999997445,0.6363636363636364,3,2,6,11,10,1,9,15,10,2,0.2,"[0, 20, 40]",0.0003,0.001,0.001,1
1981,0.002769999999999623,0.5,5,5,14,24,20,4,9,15,10,2,0.2,"[0, 20, 40]",0.0003,0.001,0.001,3
1982,0.00852999999999932,0.625,6,9,17,32,27,5,9,15,10,2,0.2,"[0, 20, 40]",0.0003,0.001,0.001,5
1983,0.0040999999999997445,0.6363636363636364,3,2,6,11,10,1,9,15,10,2,0.2,"[0, 20, 40]",0.0003,0.001,0.0015,1
1984,0.0026099999999995727,0.4583333333333333,5,4,15,24,20,4,9,15,10,2,0.2,"[0, 20, 40]",0.0003,0.001,0.0015,3
1985,0.005469999999999202,0.53125,7,5,20,32,27,5,9,15,10,2,0.2,"[0, 20, 40]",0.0003,0.001,0.0015,5
1986,0.003049999999999806,0.6363636363636364,1,3,7,11,10,1,9,15,10,2,0.2,"[0, 20, 40]",0.0003,0.0015,0.001,1
1987,0.00284999999999965,0.5,1,6,17,24,20,4,9,15,10,2,0.2,"[0, 20, 40]",0.0003,0.0015,0.001,3
1988,0.007349999999999199,0.59375,1,10,21,32,27,5,9,15,10,2,0.2,"[0, 20, 40]",0.0003,0.0015,0.001,5
1989,0.0033699999999996814,0.5454545454545454,1,2,8,11,10,1,9,15,10,2,0.2,"[0, 20, 40]",0.0003,0.0015,0.0015,1
1990,0.0020099999999994757,0.4166666666666667,1,4,19,24,20,4,9,15,10,2,0.2,"[0, 20, 40]",0.0003,0.0015,0.0015,3
1991,0.003869999999998771,0.46875,1,5,26,32,27,5,9,15,10,2,0.2,"[0, 20, 40]",0.0003,0.0015,0.0015,5
1992,0.0029899999999999137,0.6363636363636364,0,3,8,11,10,1,9,15,10,2,0.2,"[0, 20, 40]",0.0003,0.002,0.001,1
1993,0.002789999999999758,0.5,0,6,18,24,20,4,9,15,10,2,0.2,"[0, 20, 40]",0.0003,0.002,0.001,3
1994,0.007289999999999307,0.59375,0,10,22,32,27,5,9,15,10,2,0.2,"[0, 20, 40]",0.0003,0.002,0.001,5
1995,0.0033099999999997897,0.5454545454545454,0,2,9,11,10,1,9,15,10,2,0.2,"[0, 20, 40]",0.0003,0.002,0.0015,1
1996,0.0019499999999995836,0.4166666666666667,0,4,20,24,20,4,9,15,10,2,0.2,"[0, 20, 40]",0.0003,0.002,0.0015,3
1997,0.0038099999999988785,0.46875,0,5,27,32,27,5,9,15,10,2,0.2,"[0, 20, 40]",0.0003,0.002,0.0015,5
1998,0.0006499999999998396,0.5,0,1,3,4,4,0,9,15,10,2,0.2,"[0, 20, 40]",0.0005,0.001,0.001,1
1999,0.002199999999999888,0.5,2,4,8,14,13,1,9,15,10,2,0.2,"[0, 20, 40]",0.0005,0.001,0.001,3
2000,0.005449999999999596,0.5714285714285714,5,6,10,21,20,1,9,15,10,2,0.2,"[0, 20, 40]",0.0005,0.001,0.001,5
2001,0.001149999999999839,0.5,0,1,3,4,4,0,9,15,10,2,0.2,"[0, 20, 40]",0.0005,0.001,0.0015,1
2002,0.0016999999999997757,0.42857142857142855,2,3,9,14,13,1,9,15,10,2,0.2,"[0, 20, 40]",0.0005,0.001,0.0015,3
2003,0.004009999999999263,0.47619047619047616,5,4,12,21,20,1,9,15,10,2,0.2,"[0, 20, 40]",0.0005,0.001,0.0015,5
2004,0.0006499999999998396,0.5,0,1,3,4,4,0,9,15,10,2,0.2,"[0, 20, 40]",0.0005,0.0015,0.001,1
2005,0.0026599999999997372,0.5,1,4,9,14,13,1,9,15,10,2,0.2,"[0, 20, 40]",0.0005,0.0015,0.001,3
2006,0.006499999999998761,0.5714285714285714,1,6,14,21,20,1,9,15,10,2,0.2,"[0, 20, 40]",0.0005,0.0015,0.001,5
2007,0.001149999999999839,0.5,0,1,3,4,4,0,9,15,10,2,0.2,"[0, 20, 40]",0.0005,0.0015,0.0015,1
2008,0.0021599999999996253,0.42857142857142855,1,3,10,14,13,1,9,15,10,2,0.2,"[0, 20, 40]",0.0005,0.0015,0.0015,3
2009,0.0050599999999984295,0.47619047619047616,1,4,16,21,20,1,9,15,10,2,0.2,"[0, 20, 40]",0.0005,0.0015,0.0015,5
2010,0.0006499999999998396,0.5,0,1,3,4,4,0,9,15,10,2,0.2,"[0, 20, 40]",0.0005,0.002,0.001,1
2011,0.0031599999999997377,0.5,1,4,9,14,13,1,9,15,10,2,0.2,"[0, 20, 40]",0.0005,0.002,0.001,3
2012,0.006999999999998761,0.5714285714285714,1,6,14,21,20,1,9,15,10,2,0.2,"[0, 20, 40]",0.0005,0.002,0.001,5
2013,0.001149999999999839,0.5,0,1,3,4,4,0,9,15,10,2,0.2,"[0, 20, 40]",0.0005,0.002,0.0015,1
2014,0.002659999999999625,0.42857142857142855,1,3,10,14,13,1,9,15,10,2,0.2,"[0, 20, 40]",0.0005,0.002,0.0015,3
2015,0.00555999999999843,0.47619047619047616,1,4,16,21,20,1,9,15,10,2,0.2,"[0, 20, 40]",0.0005,0.002,0.0015,5
2016,0.009609999999998847,0.625,9,8,15,32,18,14,9,15,15,1,0.1,"[0, 20, 40]",0.0003,0.001,0.001,1
2017,0.019129999999997805,0.5970149253731343,16,19,32,67,40,27,9,15,15,1,0.1,"[0, 20, 40]",0.0003,0.001,0.001,3
2018,0.025759999999997212,0.6071428571428571,21,23,40,84,54,30,9,15,15,1,0.1,"[0, 20, 40]",0.0003,0.001,0.001,5
2019,0.0022199999999986154,0.46875,10,2,20,32,18,14,9,15,15,1,0.1,"[0, 20, 40]",0.0003,0.001,0.0015,1
2020,0.00881999999999727,0.4626865671641791,17,9,41,67,40,27,9,15,15,1,0.1,"[0, 20, 40]",0.0003,0.001,0.0015,3
2021,0.014289999999996863,0.4880952380952381,23,11,50,84,54,30,9,15,15,1,0.1,"[0, 20, 40]",0.0003,0.001,0.0015,5
2022,0.0121399999999986,0.625,5,10,17,32,18,14,9,15,15,1,0.1,"[0, 20, 40]",0.0003,0.0015,0.001,1
2023,0.02205999999999723,0.582089552238806,8,21,38,67,40,27,9,15,15,1,0.1,"[0, 20, 40]",0.0003,0.0015,0.001,3
2024,0.026709999999996455,0.5833333333333334,8,25,51,84,54,30,9,15,15,1,0.1,"[0, 20, 40]",0.0003,0.0015,0.001,5
2025,0.005749999999998262,0.46875,7,2,23,32,18,14,9,15,15,1,0.1,"[0, 20, 40]",0.0003,0.0015,0.0015,1
2026,0.012749999999996587,0.44776119402985076,10,9,48,67,40,27,9,15,15,1,0.1,"[0, 20, 40]",0.0003,0.0015,0.0015,3
2027,0.016739999999995984,0.4642857142857143,11,11,62,84,54,30,9,15,15,1,0.1,"[0, 20, 40]",0.0003,0.0015,0.0015,5
2028,0.012169999999998632,0.59375,3,10,19,32,18,14,9,15,15,1,0.1,"[0, 20, 40]",0.0003,0.002,0.001,1
2029,0.022979999999997263,0.5671641791044776,5,21,41,67,40,27,9,15,15,1,0.1,"[0, 20, 40]",0.0003,0.002,0.001,3
2030,0.02762999999999649,0.5714285714285714,5,25,54,84,54,30,9,15,15,1,0.1,"[0, 20, 40]",0.0003,0.002,0.001,5
2031,0.006199999999998493,0.4375,3,2,27,32,18,14,9,15,15,1,0.1,"[0, 20, 40]",0.0003,0.002,0.0015,1
2032,0.01408999999999682,0.43283582089552236,5,9,53,67,40,27,9,15,15,1,0.1,"[0, 20, 40]",0.0003,0.002,0.0015,3
2033,0.01857999999999623,0.4523809523809524,6,11,67,84,54,30,9,15,15,1,0.1,"[0, 20, 40]",0.0003,0.002,0.0015,5
2034,0.003949999999999873,0.8333333333333334,4,1,1,6,3,3,9,15,15,1,0.1,"[0, 20, 40]",0.0005,0.001,0.001,1
2035,0.015229999999999157,0.7096774193548387,11,11,9,31,20,11,9,15,15,1,0.1,"[0, 20, 40]",0.0005,0.001,0.001,3
2036,0.01894999999999865,0.6739130434782609,16,13,17,46,34,12,9,15,15,1,0.1,"[0, 20, 40]",0.0005,0.001,0.001,5
2037,0.003949999999999873,0.8333333333333334,5,0,1,6,3,3,9,15,15,1,0.1,"[0, 20, 40]",0.0005,0.001,0.0015,1
2038,0.01102999999999906,0.5806451612903226,12,6,13,31,20,11,9,15,15,1,0.1,"[0, 20, 40]",0.0005,0.001,0.0015,3
2039,0.015749999999998553,0.5869565217391305,17,8,21,46,34,12,9,15,15,1,0.1,"[0, 20, 40]",0.0005,0.001,0.0015,5
2040,0.0019899999999996353,0.5,1,1,4,6,3,3,9,15,15,1,0.1,"[0, 20, 40]",0.0005,0.0015,0.001,1
2041,0.015159999999998753,0.6451612903225806,5,11,15,31,20,11,9,15,15,1,0.1,"[0, 20, 40]",0.0005,0.0015,0.001,3
2042,0.021039999999998078,0.6304347826086957,9,13,24,46,34,12,9,15,15,1,0.1,"[0, 20, 40]",0.0005,0.0015,0.001,5
2043,0.0024899999999996353,0.5,2,0,4,6,3,3,9,15,15,1,0.1,"[0, 20, 40]",0.0005,0.0015,0.0015,1
2044,0.011459999999998657,0.5161290322580645,6,6,19,31,20,11,9,15,15,1,0.1,"[0, 20, 40]",0.0005,0.0015,0.0015,3
2045,0.018339999999997983,0.5434782608695652,10,8,28,46,34,12,9,15,15,1,0.1,"[0, 20, 40]",0.0005,0.0015,0.0015,5
2046,0.0024899999999996353,0.5,1,1,4,6,3,3,9,15,15,1,0.1,"[0, 20, 40]",0.0005,0.002,0.001,1
2047,0.015929999999998747,0.6451612903225806,3,11,17,31,20,11,9,15,15,1,0.1,"[0, 20, 40]",0.0005,0.002,0.001,3
2048,0.02170999999999786,0.6086956521739131,5,13,28,46,34,12,9,15,15,1,0.1,"[0, 20, 40]",0.0005,0.002,0.001,5
2049,0.0034899999999996353,0.5,2,0,4,6,3,3,9,15,15,1,0.1,"[0, 20, 40]",0.0005,0.002,0.0015,1
2050,0.012729999999998654,0.5161290322580645,4,6,21,31,20,11,9,15,15,1,0.1,"[0, 20, 40]",0.0005,0.002,0.0015,3
2051,0.019509999999997776,0.5217391304347826,6,8,32,46,34,12,9,15,15,1,0.1,"[0, 20, 40]",0.0005,0.002,0.0015,5
2052,0.004639999999999417,0.6666666666666666,5,3,7,15,12,3,9,15,15,1,0.2,"[0, 20, 40]",0.0003,0.001,0.001,1
2053,0.00573999999999863,0.5333333333333333,7,6,17,30,23,7,9,15,15,1,0.2,"[0, 20, 40]",0.0003,0.001,0.001,3
2054,0.0110199999999984,0.6052631578947368,10,9,19,38,30,8,9,15,15,1,0.2,"[0, 20, 40]",0.0003,0.001,0.001,5
2055,0.0018999999999995093,0.5333333333333333,5,1,9,15,12,3,9,15,15,1,0.2,"[0, 20, 40]",0.0003,0.001,0.0015,1
2056,0.0024899999999984878,0.43333333333333335,7,3,20,30,23,7,9,15,15,1,0.2,"[0, 20, 40]",0.0003,0.001,0.0015,3
2057,0.006609999999998434,0.5,10,5,23,38,30,8,9,15,15,1,0.2,"[0, 20, 40]",0.0003,0.001,0.0015,5
2058,0.006639999999999419,0.6666666666666666,4,4,7,15,12,3,9,15,15,1,0.2,"[0, 20, 40]",0.0003,0.0015,0.001,1
2059,0.00795999999999852,0.5333333333333333,4,7,19,30,23,7,9,15,15,1,0.2,"[0, 20, 40]",0.0003,0.0015,0.001,3
2060,0.011539999999998144,0.5789473684210527,4,10,24,38,30,8,9,15,15,1,0.2,"[0, 20, 40]",0.0003,0.0015,0.001,5
2061,0.0038999999999993996,0.5333333333333333,4,1,10,15,12,3,9,15,15,1,0.2,"[0, 20, 40]",0.0003,0.0015,0.0015,1
2062,0.004709999999998267,0.43333333333333335,4,3,23,30,23,7,9,15,15,1,0.2,"[0, 20, 40]",0.0003,0.0015,0.0015,3
2063,0.007129999999998068,0.47368421052631576,4,5,29,38,30,8,9,15,15,1,0.2,"[0, 20, 40]",0.0003,0.0015,0.0015,5
2064,0.00616999999999945,0.6,2,4,9,15,12,3,9,15,15,1,0.2,"[0, 20, 40]",0.0003,0.002,0.001,1
2065,0.007489999999998552,0.5,2,7,21,30,23,7,9,15,15,1,0.2,"[0, 20, 40]",0.0003,0.002,0.001,3
2066,0.011069999999998179,0.5526315789473685,2,10,26,38,30,8,9,15,15,1,0.2,"[0, 20, 40]",0.0003,0.002,0.001,5
2067,0.00342999999999943,0.4666666666666667,2,1,12,15,12,3,9,15,15,1,0.2,"[0, 20, 40]",0.0003,0.002,0.0015,1
2068,0.004239999999998297,0.4,2,3,25,30,23,7,9,15,15,1,0.2,"[0, 20, 40]",0.0003,0.002,0.0015,3
2069,0.006659999999998097,0.4473684210526316,2,5,31,38,30,8,9,15,15,1,0.2,"[0, 20, 40]",0.0003,0.002,0.0015,5
2070,0.0023499999999998726,0.75,3,0,1,4,3,1,9,15,15,1,0.2,"[0, 20, 40]",0.0005,0.001,0.001,1
2071,0.007399999999999336,0.6111111111111112,6,5,7,18,15,3,9,15,15,1,0.2,"[0, 20, 40]",0.0005,0.001,0.001,3
2072,0.008539999999999008,0.5833333333333334,7,7,10,24,21,3,9,15,15,1,0.2,"[0, 20, 40]",0.0005,0.001,0.001,5
2073,0.0023499999999998726,0.75,3,0,1,4,3,1,9,15,15,1,0.2,"[0, 20, 40]",0.0005,0.001,0.0015,1
2074,0.005619999999999165,0.5,6,3,9,18,15,3,9,15,15,1,0.2,"[0, 20, 40]",0.0005,0.001,0.0015,3
2075,0.007759999999998838,0.5,7,5,12,24,21,3,9,15,15,1,0.2,"[0, 20, 40]",0.0005,0.001,0.0015,5
2076,0.001099999999999512,0.5,1,0,3,4,3,1,9,15,15,1,0.2,"[0, 20, 40]",0.0005,0.0015,0.001,1
2077,0.007399999999998947,0.5555555555555556,3,5,10,18,15,3,9,15,15,1,0.2,"[0, 20, 40]",0.0005,0.0015,0.001,3
2078,0.00869999999999845,0.5416666666666666,3,7,14,24,21,3,9,15,15,1,0.2,"[0, 20, 40]",0.0005,0.0015,0.001,5
2079,0.001099999999999512,0.5,1,0,3,4,3,1,9,15,15,1,0.2,"[0, 20, 40]",0.0005,0.0015,0.0015,1
2080,0.005619999999998775,0.4444444444444444,3,3,12,18,15,3,9,15,15,1,0.2,"[0, 20, 40]",0.0005,0.0015,0.0015,3
2081,0.007919999999998277,0.4583333333333333,3,5,16,24,21,3,9,15,15,1,0.2,"[0, 20, 40]",0.0005,0.0015,0.0015,5
2082,0.001599999999999512,0.5,1,0,3,4,3,1,9,15,15,1,0.2,"[0, 20, 40]",0.0005,0.002,0.001,1
2083,0.007169999999998941,0.5555555555555556,1,5,12,18,15,3,9,15,15,1,0.2,"[0, 20, 40]",0.0005,0.002,0.001,3
2084,0.008469999999998442,0.5416666666666666,1,7,16,24,21,3,9,15,15,1,0.2,"[0, 20, 40]",0.0005,0.002,0.001,5
2085,0.001599999999999512,0.5,1,0,3,4,3,1,9,15,15,1,0.2,"[0, 20, 40]",0.0005,0.002,0.0015,1
2086,0.005389999999998769,0.4444444444444444,1,3,14,18,15,3,9,15,15,1,0.2,"[0, 20, 40]",0.0005,0.002,0.0015,3
2087,0.007689999999998271,0.4583333333333333,1,5,18,24,21,3,9,15,15,1,0.2,"[0, 20, 40]",0.0005,0.002,0.0015,5
2088,0.0002599999999992374,0.38095238095238093,5,1,15,21,13,8,9,15,15,2,0.1,"[0, 20, 40]",0.0003,0.001,0.001,1
2089,0.008859999999998307,0.5,12,10,28,50,34,16,9,15,15,2,0.1,"[0, 20, 40]",0.0003,0.001,0.001,3
2090,0.014729999999998057,0.5396825396825397,16,14,33,63,46,17,9,15,15,2,0.1,"[0, 20, 40]",0.0003,0.001,0.001,5
2091,0.000759999999999237,0.38095238095238093,5,1,15,21,13,8,9,15,15,2,0.1,"[0, 20, 40]",0.0003,0.001,0.0015,1
2092,0.009419999999997973,0.46,12,8,30,50,34,16,9,15,15,2,0.1,"[0, 20, 40]",0.0003,0.001,0.0015,3
2093,0.014129999999997889,0.49206349206349204,17,10,36,63,46,17,9,15,15,2,0.1,"[0, 20, 40]",0.0003,0.001,0.0015,5
2094,0.0012899999999989914,0.38095238095238093,2,2,17,21,13,8,9,15,15,2,0.1,"[0, 20, 40]",0.0003,0.0015,0.001,1
2095,0.010489999999997718,0.48,5,11,34,50,34,16,9,15,15,2,0.1,"[0, 20, 40]",0.0003,0.0015,0.001,3
2096,0.014599999999997263,0.5079365079365079,5,15,43,63,46,17,9,15,15,2,0.1,"[0, 20, 40]",0.0003,0.0015,0.001,5
2097,0.0017899999999988806,0.38095238095238093,2,1,18,21,13,8,9,15,15,2,0.1,"[0, 20, 40]",0.0003,0.0015,0.0015,1
2098,0.011049999999997272,0.44,5,8,37,50,34,16,9,15,15,2,0.1,"[0, 20, 40]",0.0003,0.0015,0.0015,3
2099,0.014499999999996986,0.4603174603174603,6,10,47,63,46,17,9,15,15,2,0.1,"[0, 20, 40]",0.0003,0.0015,0.0015,5
2100,0.002289999999998991,0.38095238095238093,2,2,17,21,13,8,9,15,15,2,0.1,"[0, 20, 40]",0.0003,0.002,0.001,1
2101,0.01237999999999772,0.48,4,11,35,50,34,16,9,15,15,2,0.1,"[0, 20, 40]",0.0003,0.002,0.001,3
2102,0.016489999999997264,0.5079365079365079,4,15,44,63,46,17,9,15,15,2,0.1,"[0, 20, 40]",0.0003,0.002,0.001,5
2103,0.0027899999999988806,0.38095238095238093,2,1,18,21,13,8,9,15,15,2,0.1,"[0, 20, 40]",0.0003,0.002,0.0015,1
2104,0.01293999999999727,0.44,4,8,38,50,34,16,9,15,15,2,0.1,"[0, 20, 40]",0.0003,0.002,0.0015,3
2105,0.016889999999996987,0.4603174603174603,5,10,48,63,46,17,9,15,15,2,0.1,"[0, 20, 40]",0.0003,0.002,0.0015,5
2106,0.002759999999999938,0.5714285714285714,4,0,3,7,5,2,9,15,15,2,0.1,"[0, 20, 40]",0.0005,0.001,0.001,1
2107,0.012159999999999496,0.68,9,8,8,25,20,5,9,15,15,2,0.1,"[0, 20, 40]",0.0005,0.001,0.001,3
2108,0.01755999999999919,0.7027027027027027,14,10,13,37,32,5,9,15,15,2,0.1,"[0, 20, 40]",0.0005,0.001,0.001,5
2109,0.002759999999999938,0.5714285714285714,4,0,3,7,5,2,9,15,15,2,0.1,"[0, 20, 40]",0.0005,0.001,0.0015,1
2110,0.011469999999999302,0.6,9,6,10,25,20,5,9,15,15,2,0.1,"[0, 20, 40]",0.0005,0.001,0.0015,3
2111,0.017869999999998994,0.6486486486486487,14,8,15,37,32,5,9,15,15,2,0.1,"[0, 20, 40]",0.0005,0.001,0.0015,5
2112,0.0007999999999997008,0.2857142857142857,1,0,6,7,5,2,9,15,15,2,0.1,"[0, 20, 40]",0.0005,0.0015,0.001,1
2113,0.011089999999999092,0.6,3,8,14,25,20,5,9,15,15,2,0.1,"[0, 20, 40]",0.0005,0.0015,0.001,3
2114,0.018649999999998612,0.6486486486486487,7,10,20,37,32,5,9,15,15,2,0.1,"[0, 20, 40]",0.0005,0.0015,0.001,5
2115,0.0007999999999997008,0.2857142857142857,1,0,6,7,5,2,9,15,15,2,0.1,"[0, 20, 40]",0.0005,0.0015,0.0015,1
2116,0.010399999999998901,0.52,3,6,16,25,20,5,9,15,15,2,0.1,"[0, 20, 40]",0.0005,0.0015,0.0015,3
2117,0.018959999999998423,0.5945945945945946,7,8,22,37,32,5,9,15,15,2,0.1,"[0, 20, 40]",0.0005,0.0015,0.0015,5
2118,0.0012999999999997007,0.2857142857142857,1,0,6,7,5,2,9,15,15,2,0.1,"[0, 20, 40]",0.0005,0.002,0.001,1
2119,0.01198999999999916,0.6,2,8,15,25,20,5,9,15,15,2,0.1,"[0, 20, 40]",0.0005,0.002,0.001,3
2120,0.019449999999998472,0.6216216216216216,4,10,23,37,32,5,9,15,15,2,0.1,"[0, 20, 40]",0.0005,0.002,0.001,5
2121,0.0012999999999997007,0.2857142857142857,1,0,6,7,5,2,9,15,15,2,0.1,"[0, 20, 40]",0.0005,0.002,0.0015,1
2122,0.01129999999999897,0.52,2,6,17,25,20,5,9,15,15,2,0.1,"[0, 20, 40]",0.0005,0.002,0.0015,3
2123,0.019759999999998282,0.5675675675675675,4,8,25,37,32,5,9,15,15,2,0.1,"[0, 20, 40]",0.0005,0.002,0.0015,5
2124,0.002379999999999847,0.5555555555555556,3,1,5,9,8,1,9,15,15,2,0.2,"[0, 20, 40]",0.0003,0.001,0.001,1
2125,0.005279999999999347,0.5454545454545454,5,6,11,22,18,4,9,15,15,2,0.2,"[0, 20, 40]",0.0003,0.001,0.001,3
2126,0.01069999999999917,0.6551724137931034,7,10,12,29,24,5,9,15,15,2,0.2,"[0, 20, 40]",0.0003,0.001,0.001,5
2127,0.0028799999999998467,0.5555555555555556,3,1,5,9,8,1,9,15,15,2,0.2,"[0, 20, 40]",0.0003,0.001,0.0015,1
2128,0.0038399999999990148,0.45454545454545453,5,4,13,22,18,4,9,15,15,2,0.2,"[0, 20, 40]",0.0003,0.001,0.0015,3
2129,0.008099999999999009,0.5517241379310345,8,6,15,29,24,5,9,15,15,2,0.2,"[0, 20, 40]",0.0003,0.001,0.0015,5
2130,0.0029299999999996204,0.5555555555555556,1,2,6,9,8,1,9,15,15,2,0.2,"[0, 20, 40]",0.0003,0.0015,0.001,1
2131,0.005309999999998988,0.5,2,7,13,22,18,4,9,15,15,2,0.2,"[0, 20, 40]",0.0003,0.0015,0.001,3
2132,0.009049999999998908,0.5862068965517241,2,11,16,29,24,5,9,15,15,2,0.2,"[0, 20, 40]",0.0003,0.0015,0.001,5
2133,0.00342999999999951,0.5555555555555556,1,1,7,9,8,1,9,15,15,2,0.2,"[0, 20, 40]",0.0003,0.0015,0.0015,1
2134,0.003869999999998547,0.4090909090909091,2,4,16,22,18,4,9,15,15,2,0.2,"[0, 20, 40]",0.0003,0.0015,0.0015,3
2135,0.0069499999999986396,0.4827586206896552,3,6,20,29,24,5,9,15,15,2,0.2,"[0, 20, 40]",0.0003,0.0015,0.0015,5
2136,0.00342999999999962,0.5555555555555556,1,2,6,9,8,1,9,15,15,2,0.2,"[0, 20, 40]",0.0003,0.002,0.001,1
2137,0.006309999999998991,0.5,2,7,13,22,18,4,9,15,15,2,0.2,"[0, 20, 40]",0.0003,0.002,0.001,3
2138,0.010049999999998909,0.5862068965517241,2,11,16,29,24,5,9,15,15,2,0.2,"[0, 20, 40]",0.0003,0.002,0.001,5
2139,0.00392999999999951,0.5555555555555556,1,1,7,9,8,1,9,15,15,2,0.2,"[0, 20, 40]",0.0003,0.002,0.0015,1
2140,0.004869999999998547,0.4090909090909091,2,4,16,22,18,4,9,15,15,2,0.2,"[0, 20, 40]",0.0003,0.002,0.0015,3
2141,0.00844999999999864,0.4827586206896552,3,6,20,29,24,5,9,15,15,2,0.2,"[0, 20, 40]",0.0003,0.002,0.0015,5
2142,0.0005499999999998725,0.3333333333333333,1,0,2,3,3,0,9,15,15,2,0.2,"[0, 20, 40]",0.0005,0.001,0.001,1
2143,0.00464999999999964,0.5384615384615384,3,4,6,13,12,1,9,15,15,2,0.2,"[0, 20, 40]",0.0005,0.001,0.001,3
2144,0.007679999999999461,0.6,6,6,8,20,19,1,9,15,15,2,0.2,"[0, 20, 40]",0.0005,0.001,0.001,5
2145,0.0005499999999998725,0.3333333333333333,1,0,2,3,3,0,9,15,15,2,0.2,"[0, 20, 40]",0.0005,0.001,0.0015,1
2146,0.004839999999999385,0.46153846153846156,3,3,7,13,12,1,9,15,15,2,0.2,"[0, 20, 40]",0.0005,0.001,0.0015,3
2147,0.008869999999999203,0.55,6,5,9,20,19,1,9,15,15,2,0.2,"[0, 20, 40]",0.0005,0.001,0.0015,5
2148,0.0004999999999996569,0.3333333333333333,0,0,3,3,3,0,9,15,15,2,0.2,"[0, 20, 40]",0.0005,0.0015,0.001,1
2149,0.005349999999999397,0.5384615384615384,1,4,8,13,12,1,9,15,15,2,0.2,"[0, 20, 40]",0.0005,0.0015,0.001,3
2150,0.009539999999999044,0.6,3,6,11,20,19,1,9,15,15,2,0.2,"[0, 20, 40]",0.0005,0.0015,0.001,5
2151,0.0004999999999996569,0.3333333333333333,0,0,3,3,3,0,9,15,15,2,0.2,"[0, 20, 40]",0.0005,0.0015,0.0015,1
2152,0.005539999999999143,0.46153846153846156,1,3,9,13,12,1,9,15,15,2,0.2,"[0, 20, 40]",0.0005,0.0015,0.0015,3
2153,0.010729999999998787,0.55,3,5,12,20,19,1,9,15,15,2,0.2,"[0, 20, 40]",0.0005,0.0015,0.0015,5
2154,0.0004999999999996569,0.3333333333333333,0,0,3,3,3,0,9,15,15,2,0.2,"[0, 20, 40]",0.0005,0.002,0.001,1
2155,0.005849999999999399,0.5384615384615384,1,4,8,13,12,1,9,15,15,2,0.2,"[0, 20, 40]",0.0005,0.002,0.001,3
2156,0.010779999999998898,0.6,2,6,12,20,19,1,9,15,15,2,0.2,"[0, 20, 40]",0.0005,0.002,0.001,5
2157,0.0004999999999996569,0.3333333333333333,0,0,3,3,3,0,9,15,15,2,0.2,"[0, 20, 40]",0.0005,0.002,0.0015,1
2158,0.006039999999999143,0.46153846153846156,1,3,9,13,12,1,9,15,15,2,0.2,"[0, 20, 40]",0.0005,0.002,0.0015,3
2159,0.01196999999999864,0.55,2,5,13,20,19,1,9,15,15,2,0.2,"[0, 20, 40]",0.0005,0.002,0.0015,5
2160,0.01979999999999978,0.7419354838709677,12,10,9,31,18,13,9,15,20,1,0.1,"[0, 20, 40]",0.0003,0.001,0.001,1
2161,0.03133999999999975,0.7213114754098361,20,21,20,61,37,24,9,15,20,1,0.1,"[0, 20, 40]",0.0003,0.001,0.001,3
2162,0.0397099999999994,0.7402597402597403,27,26,24,77,50,27,9,15,20,1,0.1,"[0, 20, 40]",0.0003,0.001,0.001,5
2163,0.018149999999999628,0.6451612903225806,13,6,12,31,18,13,9,15,20,1,0.1,"[0, 20, 40]",0.0003,0.001,0.0015,1
2164,0.02302999999999961,0.5737704918032787,20,12,29,61,37,24,9,15,20,1,0.1,"[0, 20, 40]",0.0003,0.001,0.0015,3
2165,0.032599999999999234,0.618421052631579,27,16,33,76,49,27,9,15,20,1,0.1,"[0, 20, 40]",0.0003,0.001,0.0015,5
2166,0.027759999999999566,0.7419354838709677,7,12,12,31,18,13,9,15,20,1,0.1,"[0, 20, 40]",0.0003,0.0015,0.001,1
2167,0.0405799999999992,0.7049180327868853,11,24,26,61,37,24,9,15,20,1,0.1,"[0, 20, 40]",0.0003,0.0015,0.001,3
2168,0.048939999999998623,0.7142857142857143,14,30,33,77,50,27,9,15,20,1,0.1,"[0, 20, 40]",0.0003,0.0015,0.001,5
2169,0.02760999999999942,0.6451612903225806,10,6,15,31,18,13,9,15,20,1,0.1,"[0, 20, 40]",0.0003,0.0015,0.0015,1
2170,0.03376999999999904,0.5573770491803278,13,13,35,61,37,24,9,15,20,1,0.1,"[0, 20, 40]",0.0003,0.0015,0.0015,3
2171,0.041769999999998336,0.5789473684210527,16,17,43,76,49,27,9,15,20,1,0.1,"[0, 20, 40]",0.0003,0.0015,0.0015,5
2172,0.02798999999999925,0.7419354838709677,3,12,16,31,18,13,9,15,20,1,0.1,"[0, 20, 40]",0.0003,0.002,0.001,1
2173,0.042859999999999,0.7049180327868853,7,24,30,61,37,24,9,15,20,1,0.1,"[0, 20, 40]",0.0003,0.002,0.001,3
2174,0.04914999999999826,0.7105263157894737,7,29,40,76,50,26,9,15,20,1,0.1,"[0, 20, 40]",0.0003,0.002,0.001,5
2175,0.028549999999999263,0.6451612903225806,5,6,20,31,18,13,9,15,20,1,0.1,"[0, 20, 40]",0.0003,0.002,0.0015,1
2176,0.03704999999999885,0.5573770491803278,9,13,39,61,37,24,9,15,20,1,0.1,"[0, 20, 40]",0.0003,0.002,0.0015,3
2177,0.04247999999999798,0.5733333333333334,9,16,50,75,49,26,9,15,20,1,0.1,"[0, 20, 40]",0.0003,0.002,0.0015,5
2178,0.0038899999999999235,0.8333333333333334,4,1,1,6,3,3,9,15,20,1,0.1,"[0, 20, 40]",0.0005,0.001,0.001,1
2179,0.015039999999999845,0.7586206896551724,11,10,8,29,19,10,9,15,20,1,0.1,"[0, 20, 40]",0.0005,0.001,0.001,3
2180,0.021259999999999505,0.75,16,14,14,44,33,11,9,15,20,1,0.1,"[0, 20, 40]",0.0005,0.001,0.001,5
2181,0.0038899999999999235,0.8333333333333334,5,0,1,6,3,3,9,15,20,1,0.1,"[0, 20, 40]",0.0005,0.001,0.0015,1
2182,0.0158899999999998,0.6896551724137931,12,7,10,29,19,10,9,15,20,1,0.1,"[0, 20, 40]",0.0005,0.001,0.0015,3
2183,0.021349999999999366,0.6818181818181818,18,9,17,44,33,11,9,15,20,1,0.1,"[0, 20, 40]",0.0005,0.001,0.0015,5
2184,0.0034699999999998933,0.6666666666666666,1,2,3,6,3,3,9,15,20,1,0.1,"[0, 20, 40]",0.0005,0.0015,0.001,1
2185,0.017199999999999837,0.7241379310344828,7,11,11,29,19,10,9,15,20,1,0.1,"[0, 20, 40]",0.0005,0.0015,0.001,3
2186,0.025269999999999286,0.7272727272727273,11,15,18,44,33,11,9,15,20,1,0.1,"[0, 20, 40]",0.0005,0.0015,0.001,5
2187,0.00214999999999985,0.5,2,0,4,6,3,3,9,15,20,1,0.1,"[0, 20, 40]",0.0005,0.0015,0.0015,1
2188,0.01672999999999975,0.6206896551724138,8,7,14,29,19,10,9,15,20,1,0.1,"[0, 20, 40]",0.0005,0.0015,0.0015,3
2189,0.02453999999999911,0.6363636363636364,13,9,22,44,33,11,9,15,20,1,0.1,"[0, 20, 40]",0.0005,0.0015,0.0015,5
2190,0.003969999999999894,0.6666666666666666,1,2,3,6,3,3,9,15,20,1,0.1,"[0, 20, 40]",0.0005,0.002,0.001,1
2191,0.019979999999999786,0.7241379310344828,6,11,12,29,19,10,9,15,20,1,0.1,"[0, 20, 40]",0.0005,0.002,0.001,3
2192,0.029649999999999056,0.7272727272727273,9,15,20,44,33,11,9,15,20,1,0.1,"[0, 20, 40]",0.0005,0.002,0.001,5
2193,0.00314999999999985,0.5,2,0,4,6,3,3,9,15,20,1,0.1,"[0, 20, 40]",0.0005,0.002,0.0015,1
2194,0.020009999999999698,0.6206896551724138,7,7,15,29,19,10,9,15,20,1,0.1,"[0, 20, 40]",0.0005,0.002,0.0015,3
2195,0.02991999999999889,0.6363636363636364,11,9,24,44,33,11,9,15,20,1,0.1,"[0, 20, 40]",0.0005,0.002,0.0015,5
2196,0.008189999999999914,0.7333333333333333,7,4,4,15,12,3,9,15,20,1,0.2,"[0, 20, 40]",0.0003,0.001,0.001,1
2197,0.011920000000000189,0.6785714285714286,10,8,10,28,21,7,9,15,20,1,0.2,"[0, 20, 40]",0.0003,0.001,0.001,3
2198,0.017520000000000188,0.7428571428571429,14,11,10,35,27,8,9,15,20,1,0.2,"[0, 20, 40]",0.0003,0.001,0.001,5
2199,0.008389999999999724,0.6666666666666666,7,3,5,15,12,3,9,15,20,1,0.2,"[0, 20, 40]",0.0003,0.001,0.0015,1
2200,0.009889999999999934,0.5714285714285714,10,5,13,28,21,7,9,15,20,1,0.2,"[0, 20, 40]",0.0003,0.001,0.0015,3
2201,0.01698999999999993,0.6571428571428571,14,8,13,35,27,8,9,15,20,1,0.2,"[0, 20, 40]",0.0003,0.001,0.0015,5
2202,0.01031999999999982,0.7333333333333333,5,5,5,15,12,3,9,15,20,1,0.2,"[0, 20, 40]",0.0003,0.0015,0.001,1
2203,0.014919999999999855,0.6785714285714286,6,9,13,28,21,7,9,15,20,1,0.2,"[0, 20, 40]",0.0003,0.0015,0.001,3
2204,0.021019999999999803,0.7428571428571429,8,13,14,35,27,8,9,15,20,1,0.2,"[0, 20, 40]",0.0003,0.0015,0.001,5
2205,0.01101999999999963,0.6666666666666666,6,3,6,15,12,3,9,15,20,1,0.2,"[0, 20, 40]",0.0003,0.0015,0.0015,1
2206,0.013389999999999604,0.5714285714285714,7,5,16,28,21,7,9,15,20,1,0.2,"[0, 20, 40]",0.0003,0.0015,0.0015,3
2207,0.019429999999999427,0.6285714285714286,9,8,18,35,27,8,9,15,20,1,0.2,"[0, 20, 40]",0.0003,0.0015,0.0015,5
2208,0.010109999999999616,0.7333333333333333,2,5,8,15,12,3,9,15,20,1,0.2,"[0, 20, 40]",0.0003,0.002,0.001,1
2209,0.016249999999999796,0.6785714285714286,4,9,15,28,21,7,9,15,20,1,0.2,"[0, 20, 40]",0.0003,0.002,0.001,3
2210,0.020559999999999592,0.7352941176470589,4,12,18,34,27,7,9,15,20,1,0.2,"[0, 20, 40]",0.0003,0.002,0.001,5
2211,0.011309999999999425,0.6666666666666666,3,3,9,15,12,3,9,15,20,1,0.2,"[0, 20, 40]",0.0003,0.002,0.0015,1
2212,0.015219999999999545,0.5714285714285714,5,5,18,28,21,7,9,15,20,1,0.2,"[0, 20, 40]",0.0003,0.002,0.0015,3
2213,0.018969999999999217,0.6176470588235294,5,7,22,34,27,7,9,15,20,1,0.2,"[0, 20, 40]",0.0003,0.002,0.0015,5
2214,0.0022899999999999236,0.75,3,0,1,4,3,1,9,15,20,1,0.2,"[0, 20, 40]",0.0005,0.001,0.001,1
2215,0.00892999999999992,0.7222222222222222,7,5,6,18,15,3,9,15,20,1,0.2,"[0, 20, 40]",0.0005,0.001,0.001,3
2216,0.011709999999999792,0.75,8,8,8,24,21,3,9,15,20,1,0.2,"[0, 20, 40]",0.0005,0.001,0.001,5
2217,0.0022899999999999236,0.75,3,0,1,4,3,1,9,15,20,1,0.2,"[0, 20, 40]",0.0005,0.001,0.0015,1
2218,0.009919999999999854,0.6666666666666666,7,4,7,18,15,3,9,15,20,1,0.2,"[0, 20, 40]",0.0005,0.001,0.0015,3
2219,0.01193999999999963,0.6666666666666666,8,6,10,24,21,3,9,15,20,1,0.2,"[0, 20, 40]",0.0005,0.001,0.0015,5
2220,0.00261999999999981,0.75,1,1,2,4,3,1,9,15,20,1,0.2,"[0, 20, 40]",0.0005,0.0015,0.001,1
2221,0.011259999999999805,0.7222222222222222,5,6,7,18,15,3,9,15,20,1,0.2,"[0, 20, 40]",0.0005,0.0015,0.001,3
2222,0.013889999999999469,0.75,5,9,10,24,21,3,9,15,20,1,0.2,"[0, 20, 40]",0.0005,0.0015,0.001,5
2223,0.0007999999999997668,0.5,1,0,3,4,3,1,9,15,20,1,0.2,"[0, 20, 40]",0.0005,0.0015,0.0015,1
2224,0.010429999999999696,0.6111111111111112,5,4,9,18,15,3,9,15,20,1,0.2,"[0, 20, 40]",0.0005,0.0015,0.0015,3
2225,0.012299999999999266,0.625,5,6,13,24,21,3,9,15,20,1,0.2,"[0, 20, 40]",0.0005,0.0015,0.0015,5
2226,0.00311999999999981,0.75,1,1,2,4,3,1,9,15,20,1,0.2,"[0, 20, 40]",0.0005,0.002,0.001,1
2227,0.013039999999999753,0.7222222222222222,4,6,8,18,15,3,9,15,20,1,0.2,"[0, 20, 40]",0.0005,0.002,0.001,3
2228,0.015669999999999417,0.75,4,9,11,24,21,3,9,15,20,1,0.2,"[0, 20, 40]",0.0005,0.002,0.001,5
2229,0.0012999999999997668,0.5,1,0,3,4,3,1,9,15,20,1,0.2,"[0, 20, 40]",0.0005,0.002,0.0015,1
2230,0.012209999999999643,0.6111111111111112,4,4,10,18,15,3,9,15,20,1,0.2,"[0, 20, 40]",0.0005,0.002,0.0015,3
2231,0.014079999999999213,0.625,4,6,14,24,21,3,9,15,20,1,0.2,"[0, 20, 40]",0.0005,0.002,0.0015,5
2232,0.01071999999999995,0.6,7,4,9,20,13,7,9,15,20,2,0.1,"[0, 20, 40]",0.0003,0.001,0.001,1
2233,0.020929999999999872,0.6444444444444445,14,13,18,45,31,14,9,15,20,2,0.1,"[0, 20, 40]",0.0003,0.001,0.001,3
2234,0.02859999999999974,0.6896551724137931,20,18,20,58,43,15,9,15,20,2,0.1,"[0, 20, 40]",0.0003,0.001,0.001,5
2235,0.01271999999999995,0.6,7,4,9,20,13,7,9,15,20,2,0.1,"[0, 20, 40]",0.0003,0.001,0.0015,1
2236,0.02319999999999981,0.6,14,11,20,45,31,14,9,15,20,2,0.1,"[0, 20, 40]",0.0003,0.001,0.0015,3
2237,0.03206999999999968,0.6491228070175439,20,15,22,57,42,15,9,15,20,2,0.1,"[0, 20, 40]",0.0003,0.001,0.0015,5
2238,0.016679999999999744,0.6,3,5,12,20,13,7,9,15,20,2,0.1,"[0, 20, 40]",0.0003,0.0015,0.001,1
2239,0.027399999999999286,0.6222222222222222,6,15,24,45,31,14,9,15,20,2,0.1,"[0, 20, 40]",0.0003,0.0015,0.001,3
2240,0.03571999999999894,0.6724137931034483,9,21,28,58,43,15,9,15,20,2,0.1,"[0, 20, 40]",0.0003,0.0015,0.001,5
2241,0.01917999999999974,0.6,4,4,12,20,13,7,9,15,20,2,0.1,"[0, 20, 40]",0.0003,0.0015,0.0015,1
2242,0.03066999999999922,0.5777777777777777,7,12,26,45,31,14,9,15,20,2,0.1,"[0, 20, 40]",0.0003,0.0015,0.0015,3
2243,0.03862999999999876,0.6140350877192983,10,16,31,57,42,15,9,15,20,2,0.1,"[0, 20, 40]",0.0003,0.0015,0.0015,5
2244,0.01761999999999963,0.6,2,5,13,20,13,7,9,15,20,2,0.1,"[0, 20, 40]",0.0003,0.002,0.001,1
2245,0.028849999999999126,0.6222222222222222,4,15,26,45,31,14,9,15,20,2,0.1,"[0, 20, 40]",0.0003,0.002,0.001,3
2246,0.03589999999999863,0.6724137931034483,4,21,33,58,43,15,9,15,20,2,0.1,"[0, 20, 40]",0.0003,0.002,0.001,5
2247,0.020619999999999625,0.6,3,4,13,20,13,7,9,15,20,2,0.1,"[0, 20, 40]",0.0003,0.002,0.0015,1
2248,0.032619999999999066,0.5777777777777777,5,12,28,45,31,14,9,15,20,2,0.1,"[0, 20, 40]",0.0003,0.002,0.0015,3
2249,0.03930999999999845,0.6140350877192983,5,16,36,57,42,15,9,15,20,2,0.1,"[0, 20, 40]",0.0003,0.002,0.0015,5
2250,0.004010000000000021,0.7142857142857143,4,1,2,7,5,2,9,15,20,2,0.1,"[0, 20, 40]",0.0005,0.001,0.001,1
2251,0.014010000000000203,0.7916666666666666,9,9,6,24,19,5,9,15,20,2,0.1,"[0, 20, 40]",0.0005,0.001,0.001,3
2252,0.02006000000000004,0.7777777777777778,14,12,10,36,31,5,9,15,20,2,0.1,"[0, 20, 40]",0.0005,0.001,0.001,5
2253,0.004510000000000022,0.7142857142857143,4,1,2,7,5,2,9,15,20,2,0.1,"[0, 20, 40]",0.0005,0.001,0.0015,1
2254,0.01700000000000013,0.75,9,8,7,24,19,5,9,15,20,2,0.1,"[0, 20, 40]",0.0005,0.001,0.0015,3
2255,0.022289999999999876,0.7222222222222222,14,10,12,36,31,5,9,15,20,2,0.1,"[0, 20, 40]",0.0005,0.001,0.0015,5
2256,0.003589999999999991,0.5714285714285714,1,2,4,7,5,2,9,15,20,2,0.1,"[0, 20, 40]",0.0005,0.0015,0.001,1
2257,0.015170000000000194,0.75,5,10,9,24,19,5,9,15,20,2,0.1,"[0, 20, 40]",0.0005,0.0015,0.001,3
2258,0.023069999999999827,0.75,9,13,14,36,31,5,9,15,20,2,0.1,"[0, 20, 40]",0.0005,0.0015,0.001,5
2259,0.0022699999999999483,0.42857142857142855,1,1,5,7,5,2,9,15,20,2,0.1,"[0, 20, 40]",0.0005,0.0015,0.0015,1
2260,0.01634000000000008,0.6666666666666666,5,8,11,24,19,5,9,15,20,2,0.1,"[0, 20, 40]",0.0005,0.0015,0.0015,3
2261,0.023479999999999626,0.6666666666666666,9,10,17,36,31,5,9,15,20,2,0.1,"[0, 20, 40]",0.0005,0.0015,0.0015,5
2262,0.004089999999999991,0.5714285714285714,1,2,4,7,5,2,9,15,20,2,0.1,"[0, 20, 40]",0.0005,0.002,0.001,1
2263,0.016950000000000142,0.75,4,10,10,24,19,5,9,15,20,2,0.1,"[0, 20, 40]",0.0005,0.002,0.001,3
2264,0.026449999999999595,0.75,7,13,16,36,31,5,9,15,20,2,0.1,"[0, 20, 40]",0.0005,0.002,0.001,5
2265,0.0027699999999999483,0.42857142857142855,1,1,5,7,5,2,9,15,20,2,0.1,"[0, 20, 40]",0.0005,0.002,0.0015,1
2266,0.018120000000000032,0.6666666666666666,4,8,12,24,19,5,9,15,20,2,0.1,"[0, 20, 40]",0.0005,0.002,0.0015,3
2267,0.026859999999999398,0.6666666666666666,7,10,19,36,31,5,9,15,20,2,0.1,"[0, 20, 40]",0.0005,0.002,0.0015,5
2268,0.003989999999999957,0.6666666666666666,4,2,3,9,8,1,9,15,20,2,0.2,"[0, 20, 40]",0.0003,0.001,0.001,1
2269,0.007190000000000181,0.6111111111111112,4,7,7,18,15,3,9,15,20,2,0.2,"[0, 20, 40]",0.0003,0.001,0.001,3
2270,0.012790000000000181,0.72,7,11,7,25,21,4,9,15,20,2,0.2,"[0, 20, 40]",0.0003,0.001,0.001,5
2271,0.004989999999999956,0.6666666666666666,4,2,3,9,8,1,9,15,20,2,0.2,"[0, 20, 40]",0.0003,0.001,0.0015,1
2272,0.006460000000000114,0.5,4,5,9,18,15,3,9,15,20,2,0.2,"[0, 20, 40]",0.0003,0.001,0.0015,3
2273,0.013560000000000112,0.64,8,8,9,25,21,4,9,15,20,2,0.2,"[0, 20, 40]",0.0003,0.001,0.0015,5
2274,0.004619999999999865,0.6666666666666666,2,3,4,9,8,1,9,15,20,2,0.2,"[0, 20, 40]",0.0003,0.0015,0.001,1
2275,0.007320000000000089,0.6111111111111112,1,9,8,18,15,3,9,15,20,2,0.2,"[0, 20, 40]",0.0003,0.0015,0.001,3
2276,0.012920000000000034,0.72,2,14,9,25,21,4,9,15,20,2,0.2,"[0, 20, 40]",0.0003,0.0015,0.001,5
2277,0.006119999999999864,0.6666666666666666,3,2,4,9,8,1,9,15,20,2,0.2,"[0, 20, 40]",0.0003,0.0015,0.0015,1
2278,0.007590000000000022,0.5,2,6,10,18,15,3,9,15,20,2,0.2,"[0, 20, 40]",0.0003,0.0015,0.0015,3
2279,0.01362999999999985,0.6,4,9,12,25,21,4,9,15,20,2,0.2,"[0, 20, 40]",0.0003,0.0015,0.0015,5
2280,0.005059999999999751,0.6666666666666666,1,3,5,9,8,1,9,15,20,2,0.2,"[0, 20, 40]",0.0003,0.002,0.001,1
2281,0.007259999999999975,0.6111111111111112,0,9,9,18,15,3,9,15,20,2,0.2,"[0, 20, 40]",0.0003,0.002,0.001,3
2282,0.012309999999999925,0.72,0,14,11,25,21,4,9,15,20,2,0.2,"[0, 20, 40]",0.0003,0.002,0.001,5
2283,0.0070599999999997505,0.6666666666666666,2,2,5,9,8,1,9,15,20,2,0.2,"[0, 20, 40]",0.0003,0.002,0.0015,1
2284,0.008029999999999907,0.5,1,6,11,18,15,3,9,15,20,2,0.2,"[0, 20, 40]",0.0003,0.002,0.0015,3
2285,0.014019999999999741,0.6,2,9,14,25,21,4,9,15,20,2,0.2,"[0, 20, 40]",0.0003,0.002,0.0015,5
2286,0.0014899999999999237,0.6666666666666666,1,1,1,3,3,0,9,15,20,2,0.2,"[0, 20, 40]",0.0005,0.001,0.001,1
2287,0.005090000000000102,0.6666666666666666,2,5,5,12,11,1,9,15,20,2,0.2,"[0, 20, 40]",0.0005,0.001,0.001,3
2288,0.010330000000000077,0.7894736842105263,5,8,6,19,18,1,9,15,20,2,0.2,"[0, 20, 40]",0.0005,0.001,0.001,5
2289,0.0019899999999999233,0.6666666666666666,1,1,1,3,3,0,9,15,20,2,0.2,"[0, 20, 40]",0.0005,0.001,0.0015,1
2290,0.006080000000000036,0.5833333333333334,2,4,6,12,11,1,9,15,20,2,0.2,"[0, 20, 40]",0.0005,0.001,0.0015,3
2291,0.010559999999999915,0.6842105263157895,5,6,8,19,18,1,9,15,20,2,0.2,"[0, 20, 40]",0.0005,0.001,0.0015,5
2292,0.00131999999999981,0.6666666666666666,0,1,2,3,3,0,9,15,20,2,0.2,"[0, 20, 40]",0.0005,0.0015,0.001,1
2293,0.005419999999999988,0.6666666666666666,1,5,6,12,11,1,9,15,20,2,0.2,"[0, 20, 40]",0.0005,0.0015,0.001,3
2294,0.011509999999999757,0.7894736842105263,3,8,8,19,18,1,9,15,20,2,0.2,"[0, 20, 40]",0.0005,0.0015,0.001,5
2295,0.0018199999999998098,0.6666666666666666,0,1,2,3,3,0,9,15,20,2,0.2,"[0, 20, 40]",0.0005,0.0015,0.0015,1
2296,0.006409999999999922,0.5833333333333334,1,4,7,12,11,1,9,15,20,2,0.2,"[0, 20, 40]",0.0005,0.0015,0.0015,3
2297,0.011739999999999595,0.6842105263157895,3,6,10,19,18,1,9,15,20,2,0.2,"[0, 20, 40]",0.0005,0.0015,0.0015,5
2298,0.00131999999999981,0.6666666666666666,0,1,2,3,3,0,9,15,20,2,0.2,"[0, 20, 40]",0.0005,0.002,0.001,1
2299,0.005919999999999988,0.6666666666666666,1,5,6,12,11,1,9,15,20,2,0.2,"[0, 20, 40]",0.0005,0.002,0.001,3
2300,0.012609999999999582,0.7894736842105263,2,8,9,19,18,1,9,15,20,2,0.2,"[0, 20, 40]",0.0005,0.002,0.001,5
2301,0.0018199999999998098,0.6666666666666666,0,1,2,3,3,0,9,15,20,2,0.2,"[0, 20, 40]",0.0005,0.002,0.0015,1
2302,0.006909999999999921,0.5833333333333334,1,4,7,12,11,1,9,15,20,2,0.2,"[0, 20, 40]",0.0005,0.002,0.0015,3
2303,0.012839999999999421,0.6842105263157895,2,6,11,19,18,1,9,15,20,2,0.2,"[0, 20, 40]",0.0005,0.002,0.0015,5
2304,0.007319999999998617,0.40540540540540543,5,8,24,37,22,15,9,16,5,1,0.1,"[0, 20, 40]",0.0003,0.001,0.001,1
2305,-0.0008600000000029936,0.2839506172839506,6,10,65,81,51,30,9,16,5,1,0.1,"[0, 20, 40]",0.0003,0.001,0.001,3
2306,-0.0041700000000041496,0.24509803921568626,6,11,85,102,69,33,9,16,5,1,0.1,"[0, 20, 40]",0.0003,0.001,0.001,5
2307,0.0031399999999985424,0.2972972972972973,5,4,28,37,22,15,9,16,5,1,0.1,"[0, 20, 40]",0.0003,0.001,0.0015,1
2308,-0.009030000000003223,0.20987654320987653,6,4,71,81,51,30,9,16,5,1,0.1,"[0, 20, 40]",0.0003,0.001,0.0015,3
2309,-0.01234000000000439,0.18627450980392157,7,4,91,102,69,33,9,16,5,1,0.1,"[0, 20, 40]",0.0003,0.001,0.0015,5
2310,0.006029999999998383,0.3783783783783784,0,9,28,37,22,15,9,16,5,1,0.1,"[0, 20, 40]",0.0003,0.0015,0.001,1
2311,-0.002080000000003322,0.2716049382716049,0,11,70,81,51,30,9,16,5,1,0.1,"[0, 20, 40]",0.0003,0.0015,0.001,3
2312,-0.005390000000004478,0.23529411764705882,0,12,90,102,69,33,9,16,5,1,0.1,"[0, 20, 40]",0.0003,0.0015,0.001,5
2313,0.0003299999999984549,0.24324324324324326,0,4,33,37,22,15,9,16,5,1,0.1,"[0, 20, 40]",0.0003,0.0015,0.0015,1
2314,-0.011770000000003406,0.18518518518518517,0,4,77,81,51,30,9,16,5,1,0.1,"[0, 20, 40]",0.0003,0.0015,0.0015,3
2315,-0.014980000000004698,0.16666666666666666,0,4,98,102,69,33,9,16,5,1,0.1,"[0, 20, 40]",0.0003,0.0015,0.0015,5
2316,0.006029999999998383,0.3783783783783784,0,9,28,37,22,15,9,16,5,1,0.1,"[0, 20, 40]",0.0003,0.002,0.001,1
2317,-0.002080000000003322,0.2716049382716049,0,11,70,81,51,30,9,16,5,1,0.1,"[0, 20, 40]",0.0003,0.002,0.001,3
2318,-0.005390000000004478,0.23529411764705882,0,12,90,102,69,33,9,16,5,1,0.1,"[0, 20, 40]",0.0003,0.002,0.001,5
2319,0.0003299999999984549,0.24324324324324326,0,4,33,37,22,15,9,16,5,1,0.1,"[0, 20, 40]",0.0003,0.002,0.0015,1
2320,-0.011770000000003406,0.18518518518518517,0,4,77,81,51,30,9,16,5,1,0.1,"[0, 20, 40]",0.0003,0.002,0.0015,3
2321,-0.014980000000004698,0.16666666666666666,0,4,98,102,69,33,9,16,5,1,0.1,"[0, 20, 40]",0.0003,0.002,0.0015,5
2322,0.0024199999999995545,0.6666666666666666,1,2,6,9,5,4,9,16,5,1,0.1,"[0, 20, 40]",0.0005,0.001,0.001,1
2323,0.0050599999999982204,0.47368421052631576,5,6,27,38,25,13,9,16,5,1,0.1,"[0, 20, 40]",0.0005,0.001,0.001,3
2324,0.0020899999999971245,0.4107142857142857,6,6,44,56,42,14,9,16,5,1,0.1,"[0, 20, 40]",0.0005,0.001,0.001,5
2325,-0.0021200000000006548,0.4444444444444444,1,0,8,9,5,4,9,16,5,1,0.1,"[0, 20, 40]",0.0005,0.001,0.0015,1
2326,-0.007350000000002251,0.3157894736842105,5,0,33,38,25,13,9,16,5,1,0.1,"[0, 20, 40]",0.0005,0.001,0.0015,3
2327,-0.010320000000003346,0.30357142857142855,6,0,50,56,42,14,9,16,5,1,0.1,"[0, 20, 40]",0.0005,0.001,0.0015,5
2328,0.0014499999999995291,0.5555555555555556,0,2,7,9,5,4,9,16,5,1,0.1,"[0, 20, 40]",0.0005,0.0015,0.001,1
2329,0.0034699999999980753,0.42105263157894735,1,6,31,38,25,13,9,16,5,1,0.1,"[0, 20, 40]",0.0005,0.0015,0.001,3
2330,0.0007999999999968366,0.375,1,6,49,56,42,14,9,16,5,1,0.1,"[0, 20, 40]",0.0005,0.0015,0.001,5
2331,-0.0030900000000006803,0.3333333333333333,0,0,9,9,5,4,9,16,5,1,0.1,"[0, 20, 40]",0.0005,0.0015,0.0015,1
2332,-0.008940000000002396,0.2631578947368421,1,0,37,38,25,13,9,16,5,1,0.1,"[0, 20, 40]",0.0005,0.0015,0.0015,3
2333,-0.011610000000003638,0.26785714285714285,1,0,55,56,42,14,9,16,5,1,0.1,"[0, 20, 40]",0.0005,0.0015,0.0015,5
2334,0.0014499999999995291,0.5555555555555556,0,2,7,9,5,4,9,16,5,1,0.1,"[0, 20, 40]",0.0005,0.002,0.001,1
2335,0.0037299999999980595,0.42105263157894735,0,6,32,38,25,13,9,16,5,1,0.1,"[0, 20, 40]",0.0005,0.002,0.001,3
2336,0.0010599999999968204,0.375,0,6,50,56,42,14,9,16,5,1,0.1,"[0, 20, 40]",0.0005,0.002,0.001,5
2337,-0.0030900000000006803,0.3333333333333333,0,0,9,9,5,4,9,16,5,1,0.1,"[0, 20, 40]",0.0005,0.002,0.0015,1
2338,-0.008680000000002413,0.2631578947368421,0,0,38,38,25,13,9,16,5,1,0.1,"[0, 20, 40]",0.0005,0.002,0.0015,3
2339,-0.011350000000003654,0.26785714285714285,0,0,56,56,42,14,9,16,5,1,0.1,"[0, 20, 40]",0.0005,0.002,0.0015,5
2340,0.004659999999999486,0.4444444444444444,3,3,12,18,15,3,9,16,5,1,0.2,"[0, 20, 40]",0.0003,0.001,0.001,1
2341,-0.0009900000000009784,0.32432432432432434,3,4,30,37,30,7,9,16,5,1,0.2,"[0, 20, 40]",0.0003,0.001,0.001,3
2342,-0.004020000000001086,0.25,3,4,41,48,40,8,9,16,5,1,0.2,"[0, 20, 40]",0.0003,0.001,0.001,5
2343,0.00389999999999939,0.3888888888888889,3,2,13,18,15,3,9,16,5,1,0.2,"[0, 20, 40]",0.0003,0.001,0.0015,1
2344,-0.0035300000000010752,0.2702702702702703,3,2,32,37,30,7,9,16,5,1,0.2,"[0, 20, 40]",0.0003,0.001,0.0015,3
2345,-0.006560000000001181,0.20833333333333334,3,2,43,48,40,8,9,16,5,1,0.2,"[0, 20, 40]",0.0003,0.001,0.0015,5
2346,0.0033099999999994145,0.3888888888888889,0,3,15,18,15,3,9,16,5,1,0.2,"[0, 20, 40]",0.0003,0.0015,0.001,1
2347,-0.0023400000000010496,0.2972972972972973,0,4,33,37,30,7,9,16,5,1,0.2,"[0, 20, 40]",0.0003,0.0015,0.001,3
2348,-0.005370000000001157,0.22916666666666666,0,4,44,48,40,8,9,16,5,1,0.2,"[0, 20, 40]",0.0003,0.0015,0.001,5
2349,0.0025499999999993184,0.3333333333333333,0,2,16,18,15,3,9,16,5,1,0.2,"[0, 20, 40]",0.0003,0.0015,0.0015,1
2350,-0.004880000000001146,0.24324324324324326,0,2,35,37,30,7,9,16,5,1,0.2,"[0, 20, 40]",0.0003,0.0015,0.0015,3
2351,-0.007910000000001253,0.1875,0,2,46,48,40,8,9,16,5,1,0.2,"[0, 20, 40]",0.0003,0.0015,0.0015,5
2352,0.0033099999999994145,0.3888888888888889,0,3,15,18,15,3,9,16,5,1,0.2,"[0, 20, 40]",0.0003,0.002,0.001,1
2353,-0.0023400000000010496,0.2972972972972973,0,4,33,37,30,7,9,16,5,1,0.2,"[0, 20, 40]",0.0003,0.002,0.001,3
2354,-0.005370000000001157,0.22916666666666666,0,4,44,48,40,8,9,16,5,1,0.2,"[0, 20, 40]",0.0003,0.002,0.001,5
2355,0.0025499999999993184,0.3333333333333333,0,2,16,18,15,3,9,16,5,1,0.2,"[0, 20, 40]",0.0003,0.002,0.0015,1
2356,-0.004880000000001146,0.24324324324324326,0,2,35,37,30,7,9,16,5,1,0.2,"[0, 20, 40]",0.0003,0.002,0.0015,3
2357,-0.007910000000001253,0.1875,0,2,46,48,40,8,9,16,5,1,0.2,"[0, 20, 40]",0.0003,0.002,0.0015,5
2358,0.0017999999999995797,0.8,0,1,4,5,4,1,9,16,5,1,0.2,"[0, 20, 40]",0.0005,0.001,0.001,1
2359,0.0008499999999987517,0.4090909090909091,2,3,17,22,19,3,9,16,5,1,0.2,"[0, 20, 40]",0.0005,0.001,0.001,3
2360,-0.001390000000001689,0.3225806451612903,2,3,26,31,28,3,9,16,5,1,0.2,"[0, 20, 40]",0.0005,0.001,0.001,5
2361,-0.0004800000000005905,0.6,0,0,5,5,4,1,9,16,5,1,0.2,"[0, 20, 40]",0.0005,0.001,0.0015,1
2362,-0.0054900000000015865,0.2727272727272727,2,0,20,22,19,3,9,16,5,1,0.2,"[0, 20, 40]",0.0005,0.001,0.0015,3
2363,-0.00773000000000203,0.22580645161290322,2,0,29,31,28,3,9,16,5,1,0.2,"[0, 20, 40]",0.0005,0.001,0.0015,5
2364,0.0017999999999995797,0.8,0,1,4,5,4,1,9,16,5,1,0.2,"[0, 20, 40]",0.0005,0.0015,0.001,1
2365,0.0005699999999986381,0.36363636363636365,1,3,18,22,19,3,9,16,5,1,0.2,"[0, 20, 40]",0.0005,0.0015,0.001,3
2366,-0.001670000000001802,0.2903225806451613,1,3,27,31,28,3,9,16,5,1,0.2,"[0, 20, 40]",0.0005,0.0015,0.001,5
2367,-0.0004800000000005905,0.6,0,0,5,5,4,1,9,16,5,1,0.2,"[0, 20, 40]",0.0005,0.0015,0.0015,1
2368,-0.005770000000001701,0.22727272727272727,1,0,21,22,19,3,9,16,5,1,0.2,"[0, 20, 40]",0.0005,0.0015,0.0015,3
2369,-0.008010000000002144,0.1935483870967742,1,0,30,31,28,3,9,16,5,1,0.2,"[0, 20, 40]",0.0005,0.0015,0.0015,5
2370,0.0017999999999995797,0.8,0,1,4,5,4,1,9,16,5,1,0.2,"[0, 20, 40]",0.0005,0.002,0.001,1
2371,0.0008299999999986219,0.36363636363636365,0,3,19,22,19,3,9,16,5,1,0.2,"[0, 20, 40]",0.0005,0.002,0.001,3
2372,-0.0014100000000018182,0.2903225806451613,0,3,28,31,28,3,9,16,5,1,0.2,"[0, 20, 40]",0.0005,0.002,0.001,5
2373,-0.0004800000000005905,0.6,0,0,5,5,4,1,9,16,5,1,0.2,"[0, 20, 40]",0.0005,0.002,0.0015,1
2374,-0.0055100000000017175,0.22727272727272727,0,0,22,22,19,3,9,16,5,1,0.2,"[0, 20, 40]",0.0005,0.002,0.0015,3
2375,-0.007750000000002158,0.1935483870967742,0,0,31,31,28,3,9,16,5,1,0.2,"[0, 20, 40]",0.0005,0.002,0.0015,5
2376,0.0029799999999990706,0.34615384615384615,3,4,19,26,17,9,9,16,5,2,0.1,"[0, 20, 40]",0.0003,0.001,0.001,1
2377,-0.005570000000002839,0.23076923076923078,4,6,55,65,47,18,9,16,5,2,0.1,"[0, 20, 40]",0.0003,0.001,0.001,3
2378,-0.007850000000003831,0.2073170731707317,4,7,71,82,63,19,9,16,5,2,0.1,"[0, 20, 40]",0.0003,0.001,0.001,5
2379,0.0034199999999991204,0.3076923076923077,3,3,20,26,17,9,9,16,5,2,0.1,"[0, 20, 40]",0.0003,0.001,0.0015,1
2380,-0.009120000000002957,0.18461538461538463,4,3,58,65,47,18,9,16,5,2,0.1,"[0, 20, 40]",0.0003,0.001,0.0015,3
2381,-0.011400000000003945,0.17073170731707318,5,3,74,82,63,19,9,16,5,2,0.1,"[0, 20, 40]",0.0003,0.001,0.0015,5
2382,0.001189999999999004,0.3076923076923077,0,4,22,26,17,9,9,16,5,2,0.1,"[0, 20, 40]",0.0003,0.0015,0.001,1
2383,-0.007290000000003001,0.2153846153846154,0,6,59,65,47,18,9,16,5,2,0.1,"[0, 20, 40]",0.0003,0.0015,0.001,3
2384,-0.009570000000003999,0.1951219512195122,0,7,75,82,63,19,9,16,5,2,0.1,"[0, 20, 40]",0.0003,0.0015,0.001,5
2385,0.0016299999999990536,0.2692307692307692,0,3,23,26,17,9,9,16,5,2,0.1,"[0, 20, 40]",0.0003,0.0015,0.0015,1
2386,-0.010840000000003121,0.16923076923076924,0,3,62,65,47,18,9,16,5,2,0.1,"[0, 20, 40]",0.0003,0.0015,0.0015,3
2387,-0.013020000000004233,0.15853658536585366,0,3,79,82,63,19,9,16,5,2,0.1,"[0, 20, 40]",0.0003,0.0015,0.0015,5
2388,0.001189999999999004,0.3076923076923077,0,4,22,26,17,9,9,16,5,2,0.1,"[0, 20, 40]",0.0003,0.002,0.001,1
2389,-0.007290000000003001,0.2153846153846154,0,6,59,65,47,18,9,16,5,2,0.1,"[0, 20, 40]",0.0003,0.002,0.001,3
2390,-0.009570000000003999,0.1951219512195122,0,7,75,82,63,19,9,16,5,2,0.1,"[0, 20, 40]",0.0003,0.002,0.001,5
2391,0.0016299999999990536,0.2692307692307692,0,3,23,26,17,9,9,16,5,2,0.1,"[0, 20, 40]",0.0003,0.002,0.0015,1
2392,-0.010840000000003121,0.16923076923076924,0,3,62,65,47,18,9,16,5,2,0.1,"[0, 20, 40]",0.0003,0.002,0.0015,3
2393,-0.013020000000004233,0.15853658536585366,0,3,79,82,63,19,9,16,5,2,0.1,"[0, 20, 40]",0.0003,0.002,0.0015,5
2394,0.002489999999999769,0.6,1,2,7,10,7,3,9,16,5,2,0.1,"[0, 20, 40]",0.0005,0.001,0.001,1
2395,0.0029799999999988473,0.45161290322580644,3,5,23,31,25,6,9,16,5,2,0.1,"[0, 20, 40]",0.0005,0.001,0.001,3
2396,0.0015999999999982229,0.40425531914893614,4,5,38,47,41,6,9,16,5,2,0.1,"[0, 20, 40]",0.0005,0.001,0.001,5
2397,-0.0020500000000004404,0.4,1,0,9,10,7,3,9,16,5,2,0.1,"[0, 20, 40]",0.0005,0.001,0.0015,1
2398,-0.007630000000001712,0.2903225806451613,3,0,28,31,25,6,9,16,5,2,0.1,"[0, 20, 40]",0.0005,0.001,0.0015,3
2399,-0.009010000000002334,0.2978723404255319,4,0,43,47,41,6,9,16,5,2,0.1,"[0, 20, 40]",0.0005,0.001,0.0015,5
2400,0.0015199999999997433,0.5,0,2,8,10,7,3,9,16,5,2,0.1,"[0, 20, 40]",0.0005,0.0015,0.001,1
2401,0.0013699999999986273,0.3870967741935484,0,5,26,31,25,6,9,16,5,2,0.1,"[0, 20, 40]",0.0005,0.0015,0.001,3
2402,0.00028999999999786044,0.3617021276595745,0,5,42,47,41,6,9,16,5,2,0.1,"[0, 20, 40]",0.0005,0.0015,0.001,5
2403,-0.003020000000000466,0.3,0,0,10,10,7,3,9,16,5,2,0.1,"[0, 20, 40]",0.0005,0.0015,0.0015,1
2404,-0.00924000000000193,0.22580645161290322,0,0,31,31,25,6,9,16,5,2,0.1,"[0, 20, 40]",0.0005,0.0015,0.0015,3
2405,-0.010320000000002699,0.2553191489361702,0,0,47,47,41,6,9,16,5,2,0.1,"[0, 20, 40]",0.0005,0.0015,0.0015,5
2406,0.0015199999999997433,0.5,0,2,8,10,7,3,9,16,5,2,0.1,"[0, 20, 40]",0.0005,0.002,0.001,1
2407,0.0013699999999986273,0.3870967741935484,0,5,26,31,25,6,9,16,5,2,0.1,"[0, 20, 40]",0.0005,0.002,0.001,3
2408,0.00028999999999786044,0.3617021276595745,0,5,42,47,41,6,9,16,5,2,0.1,"[0, 20, 40]",0.0005,0.002,0.001,5
2409,-0.003020000000000466,0.3,0,0,10,10,7,3,9,16,5,2,0.1,"[0, 20, 40]",0.0005,0.002,0.0015,1
2410,-0.00924000000000193,0.22580645161290322,0,0,31,31,25,6,9,16,5,2,0.1,"[0, 20, 40]",0.0005,0.002,0.0015,3
2411,-0.010320000000002699,0.2553191489361702,0,0,47,47,41,6,9,16,5,2,0.1,"[0, 20, 40]",0.0005,0.002,0.0015,5
2412,0.003209999999999555,0.5,3,2,7,12,11,1,9,16,5,2,0.2,"[0, 20, 40]",0.0003,0.001,0.001,1
2413,-0.0015600000000013398,0.3,3,3,24,30,26,4,9,16,5,2,0.2,"[0, 20, 40]",0.0003,0.001,0.001,3
2414,-0.003040000000001619,0.24390243902439024,3,4,34,41,36,5,9,16,5,2,0.2,"[0, 20, 40]",0.0003,0.001,0.001,5
2415,0.004209999999999554,0.5,3,2,7,12,11,1,9,16,5,2,0.2,"[0, 20, 40]",0.0003,0.001,0.0015,1
2416,-0.0023400000000013427,0.26666666666666666,3,2,25,30,26,4,9,16,5,2,0.2,"[0, 20, 40]",0.0003,0.001,0.0015,3
2417,-0.003820000000001621,0.21951219512195122,4,2,35,41,36,5,9,16,5,2,0.2,"[0, 20, 40]",0.0003,0.001,0.0015,5
2418,0.001419999999999488,0.4166666666666667,0,2,10,12,11,1,9,16,5,2,0.2,"[0, 20, 40]",0.0003,0.0015,0.001,1
2419,-0.0033500000000014065,0.26666666666666666,0,3,27,30,26,4,9,16,5,2,0.2,"[0, 20, 40]",0.0003,0.0015,0.001,3
2420,-0.0048300000000016845,0.21951219512195122,0,4,37,41,36,5,9,16,5,2,0.2,"[0, 20, 40]",0.0003,0.0015,0.001,5
2421,0.0024199999999994877,0.4166666666666667,0,2,10,12,11,1,9,16,5,2,0.2,"[0, 20, 40]",0.0003,0.0015,0.0015,1
2422,-0.0041300000000014095,0.23333333333333334,0,2,28,30,26,4,9,16,5,2,0.2,"[0, 20, 40]",0.0003,0.0015,0.0015,3
2423,-0.005510000000001809,0.1951219512195122,0,2,39,41,36,5,9,16,5,2,0.2,"[0, 20, 40]",0.0003,0.0015,0.0015,5
2424,0.001419999999999488,0.4166666666666667,0,2,10,12,11,1,9,16,5,2,0.2,"[0, 20, 40]",0.0003,0.002,0.001,1
2425,-0.0033500000000014065,0.26666666666666666,0,3,27,30,26,4,9,16,5,2,0.2,"[0, 20, 40]",0.0003,0.002,0.001,3
2426,-0.0048300000000016845,0.21951219512195122,0,4,37,41,36,5,9,16,5,2,0.2,"[0, 20, 40]",0.0003,0.002,0.001,5
2427,0.0024199999999994877,0.4166666666666667,0,2,10,12,11,1,9,16,5,2,0.2,"[0, 20, 40]",0.0003,0.002,0.0015,1
2428,-0.0041300000000014095,0.23333333333333334,0,2,28,30,26,4,9,16,5,2,0.2,"[0, 20, 40]",0.0003,0.002,0.0015,3
2429,-0.005510000000001809,0.1951219512195122,0,2,39,41,36,5,9,16,5,2,0.2,"[0, 20, 40]",0.0003,0.002,0.0015,5
2430,0.0005699999999997595,0.5,0,1,3,4,4,0,9,16,5,2,0.2,"[0, 20, 40]",0.0005,0.001,0.001,1
2431,0.0013799999999992473,0.4375,2,3,11,16,15,1,9,16,5,2,0.2,"[0, 20, 40]",0.0005,0.001,0.001,3
2432,0.0012699999999988601,0.38461538461538464,3,3,20,26,25,1,9,16,5,2,0.2,"[0, 20, 40]",0.0005,0.001,0.001,5
2433,-0.0017100000000004108,0.25,0,0,4,4,4,0,9,16,5,2,0.2,"[0, 20, 40]",0.0005,0.001,0.0015,1
2434,-0.004960000000001095,0.25,2,0,14,16,15,1,9,16,5,2,0.2,"[0, 20, 40]",0.0005,0.001,0.0015,3
2435,-0.0050700000000014804,0.2692307692307692,3,0,23,26,25,1,9,16,5,2,0.2,"[0, 20, 40]",0.0005,0.001,0.0015,5
2436,0.0005699999999997595,0.5,0,1,3,4,4,0,9,16,5,2,0.2,"[0, 20, 40]",0.0005,0.0015,0.001,1
2437,0.0007399999999990524,0.375,0,3,13,16,15,1,9,16,5,2,0.2,"[0, 20, 40]",0.0005,0.0015,0.001,3
2438,0.0009299999999985225,0.34615384615384615,0,3,23,26,25,1,9,16,5,2,0.2,"[0, 20, 40]",0.0005,0.0015,0.001,5
2439,-0.0017100000000004108,0.25,0,0,4,4,4,0,9,16,5,2,0.2,"[0, 20, 40]",0.0005,0.0015,0.0015,1
2440,-0.005600000000001289,0.1875,0,0,16,16,15,1,9,16,5,2,0.2,"[0, 20, 40]",0.0005,0.0015,0.0015,3
2441,-0.005410000000001818,0.23076923076923078,0,0,26,26,25,1,9,16,5,2,0.2,"[0, 20, 40]",0.0005,0.0015,0.0015,5
2442,0.0005699999999997595,0.5,0,1,3,4,4,0,9,16,5,2,0.2,"[0, 20, 40]",0.0005,0.002,0.001,1
2443,0.0007399999999990524,0.375,0,3,13,16,15,1,9,16,5,2,0.2,"[0, 20, 40]",0.0005,0.002,0.001,3
2444,0.0009299999999985225,0.34615384615384615,0,3,23,26,25,1,9,16,5,2,0.2,"[0, 20, 40]",0.0005,0.002,0.001,5
2445,-0.0017100000000004108,0.25,0,0,4,4,4,0,9,16,5,2,0.2,"[0, 20, 40]",0.0005,0.002,0.0015,1
2446,-0.005600000000001289,0.1875,0,0,16,16,15,1,9,16,5,2,0.2,"[0, 20, 40]",0.0005,0.002,0.0015,3
2447,-0.005410000000001818,0.23076923076923078,0,0,26,26,25,1,9,16,5,2,0.2,"[0, 20, 40]",0.0005,0.002,0.0015,5
2448,0.009979999999998606,0.5405405405405406,8,8,21,37,22,15,9,16,10,1,0.1,"[0, 20, 40]",0.0003,0.001,0.001,1
2449,0.007909999999998253,0.4268292682926829,16,14,52,82,52,30,9,16,10,1,0.1,"[0, 20, 40]",0.0003,0.001,0.001,3
2450,0.013859999999997548,0.4519230769230769,19,18,67,104,71,33,9,16,10,1,0.1,"[0, 20, 40]",0.0003,0.001,0.001,5
2451,0.007109999999998684,0.43243243243243246,8,4,25,37,22,15,9,16,10,1,0.1,"[0, 20, 40]",0.0003,0.001,0.0015,1
2452,0.0036299999999981915,0.35365853658536583,16,8,58,82,52,30,9,16,10,1,0.1,"[0, 20, 40]",0.0003,0.001,0.0015,3
2453,0.006679999999997426,0.375,20,9,75,104,71,33,9,16,10,1,0.1,"[0, 20, 40]",0.0003,0.001,0.0015,5
2454,0.01157999999999865,0.5405405405405406,4,10,23,37,22,15,9,16,10,1,0.1,"[0, 20, 40]",0.0003,0.0015,0.001,1
2455,0.008649999999998003,0.4268292682926829,4,16,62,82,52,30,9,16,10,1,0.1,"[0, 20, 40]",0.0003,0.0015,0.001,3
2456,0.013159999999996857,0.4423076923076923,4,20,80,104,71,33,9,16,10,1,0.1,"[0, 20, 40]",0.0003,0.0015,0.001,5
2457,0.008529999999998598,0.40540540540540543,5,4,28,37,22,15,9,16,10,1,0.1,"[0, 20, 40]",0.0003,0.0015,0.0015,1
2458,0.004189999999997819,0.34146341463414637,5,8,69,82,52,30,9,16,10,1,0.1,"[0, 20, 40]",0.0003,0.0015,0.0015,3
2459,0.006059999999996427,0.3557692307692308,5,9,90,104,71,33,9,16,10,1,0.1,"[0, 20, 40]",0.0003,0.0015,0.0015,5
2460,0.011249999999998489,0.5405405405405406,2,10,25,37,22,15,9,16,10,1,0.1,"[0, 20, 40]",0.0003,0.002,0.001,1
2461,0.00831999999999784,0.4268292682926829,2,16,64,82,52,30,9,16,10,1,0.1,"[0, 20, 40]",0.0003,0.002,0.001,3
2462,0.012829999999996698,0.4423076923076923,2,20,82,104,71,33,9,16,10,1,0.1,"[0, 20, 40]",0.0003,0.002,0.001,5
2463,0.008529999999998436,0.40540540540540543,2,4,31,37,22,15,9,16,10,1,0.1,"[0, 20, 40]",0.0003,0.002,0.0015,1
2464,0.004189999999997655,0.34146341463414637,2,8,72,82,52,30,9,16,10,1,0.1,"[0, 20, 40]",0.0003,0.002,0.0015,3
2465,0.006059999999996264,0.3557692307692308,2,9,93,104,71,33,9,16,10,1,0.1,"[0, 20, 40]",0.0003,0.002,0.0015,5
2466,0.0052399999999999305,0.7777777777777778,3,3,3,9,5,4,9,16,10,1,0.1,"[0, 20, 40]",0.0005,0.001,0.001,1
2467,0.011719999999999633,0.5641025641025641,10,9,20,39,26,13,9,16,10,1,0.1,"[0, 20, 40]",0.0005,0.001,0.001,3
2468,0.016059999999998666,0.5689655172413793,15,11,32,58,44,14,9,16,10,1,0.1,"[0, 20, 40]",0.0005,0.001,0.001,5
2469,0.0025599999999999707,0.5555555555555556,3,1,5,9,5,4,9,16,10,1,0.1,"[0, 20, 40]",0.0005,0.001,0.0015,1
2470,0.007829999999999518,0.46153846153846156,10,5,24,39,26,13,9,16,10,1,0.1,"[0, 20, 40]",0.0005,0.001,0.0015,3
2471,0.011229999999998328,0.4827586206896552,15,6,37,58,44,14,9,16,10,1,0.1,"[0, 20, 40]",0.0005,0.001,0.0015,5
2472,0.0040099999999997,0.5555555555555556,1,3,5,9,5,4,9,16,10,1,0.1,"[0, 20, 40]",0.0005,0.0015,0.001,1
2473,0.01268999999999927,0.5128205128205128,5,9,25,39,26,13,9,16,10,1,0.1,"[0, 20, 40]",0.0005,0.0015,0.001,3
2474,0.018619999999997628,0.5344827586206896,7,11,40,58,44,14,9,16,10,1,0.1,"[0, 20, 40]",0.0005,0.0015,0.001,5
2475,0.0013299999999997413,0.3333333333333333,1,1,7,9,5,4,9,16,10,1,0.1,"[0, 20, 40]",0.0005,0.0015,0.0015,1
2476,0.008799999999999154,0.41025641025641024,5,5,29,39,26,13,9,16,10,1,0.1,"[0, 20, 40]",0.0005,0.0015,0.0015,3
2477,0.013789999999997277,0.4482758620689655,7,6,45,58,44,14,9,16,10,1,0.1,"[0, 20, 40]",0.0005,0.0015,0.0015,5
2478,0.0045099999999997,0.5555555555555556,1,3,5,9,5,4,9,16,10,1,0.1,"[0, 20, 40]",0.0005,0.002,0.001,1
2479,0.012189999999998938,0.48717948717948717,3,9,27,39,26,13,9,16,10,1,0.1,"[0, 20, 40]",0.0005,0.002,0.001,3
2480,0.018159999999997224,0.5172413793103449,4,11,43,58,44,14,9,16,10,1,0.1,"[0, 20, 40]",0.0005,0.002,0.001,5
2481,0.0018299999999997413,0.3333333333333333,1,1,7,9,5,4,9,16,10,1,0.1,"[0, 20, 40]",0.0005,0.002,0.0015,1
2482,0.008299999999998826,0.38461538461538464,3,5,31,39,26,13,9,16,10,1,0.1,"[0, 20, 40]",0.0005,0.002,0.0015,3
2483,0.013329999999996874,0.43103448275862066,4,6,48,58,44,14,9,16,10,1,0.1,"[0, 20, 40]",0.0005,0.002,0.0015,5
2484,0.006169999999999718,0.6111111111111112,6,3,9,18,15,3,9,16,10,1,0.2,"[0, 20, 40]",0.0003,0.001,0.001,1
2485,0.003959999999999801,0.43243243243243246,8,6,23,37,30,7,9,16,10,1,0.2,"[0, 20, 40]",0.0003,0.001,0.001,3
2486,0.009489999999999459,0.4897959183673469,10,9,30,49,41,8,9,16,10,1,0.2,"[0, 20, 40]",0.0003,0.001,0.001,5
2487,0.006239999999999734,0.5555555555555556,6,2,10,18,15,3,9,16,10,1,0.2,"[0, 20, 40]",0.0003,0.001,0.0015,1
2488,0.0028699999999997664,0.3783783783783784,8,4,25,37,30,7,9,16,10,1,0.2,"[0, 20, 40]",0.0003,0.001,0.0015,3
2489,0.0054999999999993535,0.40816326530612246,10,5,34,49,41,8,9,16,10,1,0.2,"[0, 20, 40]",0.0003,0.001,0.0015,5
2490,0.007269999999999763,0.6111111111111112,3,4,11,18,15,3,9,16,10,1,0.2,"[0, 20, 40]",0.0003,0.0015,0.001,1
2491,0.0045399999999997725,0.43243243243243246,3,7,27,37,30,7,9,16,10,1,0.2,"[0, 20, 40]",0.0003,0.0015,0.001,3
2492,0.008589999999999065,0.46938775510204084,3,10,36,49,41,8,9,16,10,1,0.2,"[0, 20, 40]",0.0003,0.0015,0.001,5
2493,0.006659999999999655,0.5,3,2,13,18,15,3,9,16,10,1,0.2,"[0, 20, 40]",0.0003,0.0015,0.0015,1
2494,0.002769999999999614,0.35135135135135137,3,4,30,37,30,7,9,16,10,1,0.2,"[0, 20, 40]",0.0003,0.0015,0.0015,3
2495,0.003919999999998833,0.3673469387755102,3,5,41,49,41,8,9,16,10,1,0.2,"[0, 20, 40]",0.0003,0.0015,0.0015,5
2496,0.006439999999999601,0.6111111111111112,1,4,13,18,15,3,9,16,10,1,0.2,"[0, 20, 40]",0.0003,0.002,0.001,1
2497,0.0037099999999996107,0.43243243243243246,1,7,29,37,30,7,9,16,10,1,0.2,"[0, 20, 40]",0.0003,0.002,0.001,3
2498,0.007759999999998903,0.46938775510204084,1,10,38,49,41,8,9,16,10,1,0.2,"[0, 20, 40]",0.0003,0.002,0.001,5
2499,0.005829999999999493,0.5,1,2,15,18,15,3,9,16,10,1,0.2,"[0, 20, 40]",0.0003,0.002,0.0015,1
2500,0.0019399999999994528,0.35135135135135137,1,4,32,37,30,7,9,16,10,1,0.2,"[0, 20, 40]",0.0003,0.002,0.0015,3
2501,0.00308999999999867,0.3673469387755102,1,5,43,49,41,8,9,16,10,1,0.2,"[0, 20, 40]",0.0003,0.002,0.0015,5
2502,0.002759999999999872,0.8,2,1,2,5,4,1,9,16,10,1,0.2,"[0, 20, 40]",0.0005,0.001,0.001,1
2503,0.004979999999999826,0.5454545454545454,5,4,13,22,19,3,9,16,10,1,0.2,"[0, 20, 40]",0.0005,0.001,0.001,3
2504,0.007079999999999262,0.5625,6,6,20,32,29,3,9,16,10,1,0.2,"[0, 20, 40]",0.0005,0.001,0.001,5
2505,0.0032599999999998715,0.8,2,1,2,5,4,1,9,16,10,1,0.2,"[0, 20, 40]",0.0005,0.001,0.0015,1
2506,0.004479999999999713,0.5,5,3,14,22,19,3,9,16,10,1,0.2,"[0, 20, 40]",0.0005,0.001,0.0015,3
2507,0.0056399999999989315,0.5,6,4,22,32,29,3,9,16,10,1,0.2,"[0, 20, 40]",0.0005,0.001,0.0015,5
2508,0.002639999999999697,0.6,1,1,3,5,4,1,9,16,10,1,0.2,"[0, 20, 40]",0.0005,0.0015,0.001,1
2509,0.0053199999999996115,0.5,2,4,16,22,19,3,9,16,10,1,0.2,"[0, 20, 40]",0.0005,0.0015,0.001,3
2510,0.007299999999998819,0.53125,2,6,24,32,29,3,9,16,10,1,0.2,"[0, 20, 40]",0.0005,0.0015,0.001,5
2511,0.0031399999999996964,0.6,1,1,3,5,4,1,9,16,10,1,0.2,"[0, 20, 40]",0.0005,0.0015,0.0015,1
2512,0.004819999999999501,0.45454545454545453,2,3,17,22,19,3,9,16,10,1,0.2,"[0, 20, 40]",0.0005,0.0015,0.0015,3
2513,0.005859999999998487,0.46875,2,4,26,32,29,3,9,16,10,1,0.2,"[0, 20, 40]",0.0005,0.0015,0.0015,5
2514,0.003139999999999697,0.6,1,1,3,5,4,1,9,16,10,1,0.2,"[0, 20, 40]",0.0005,0.002,0.001,1
2515,0.004639999999999487,0.45454545454545453,1,4,17,22,19,3,9,16,10,1,0.2,"[0, 20, 40]",0.0005,0.002,0.001,3
2516,0.006619999999998692,0.5,1,6,25,32,29,3,9,16,10,1,0.2,"[0, 20, 40]",0.0005,0.002,0.001,5
2517,0.0036399999999996964,0.6,1,1,3,5,4,1,9,16,10,1,0.2,"[0, 20, 40]",0.0005,0.002,0.0015,1
2518,0.004139999999999374,0.4090909090909091,1,3,18,22,19,3,9,16,10,1,0.2,"[0, 20, 40]",0.0005,0.002,0.0015,3
2519,0.005179999999998362,0.4375,1,4,27,32,29,3,9,16,10,1,0.2,"[0, 20, 40]",0.0005,0.002,0.0015,5
2520,0.003909999999998834,0.4230769230769231,4,4,18,26,17,9,9,16,10,2,0.1,"[0, 20, 40]",0.0003,0.001,0.001,1
2521,0.003879999999998077,0.3787878787878788,11,10,45,66,48,18,9,16,10,2,0.1,"[0, 20, 40]",0.0003,0.001,0.001,3
2522,0.009939999999997524,0.42857142857142855,14,14,56,84,65,19,9,16,10,2,0.1,"[0, 20, 40]",0.0003,0.001,0.001,5
2523,0.004489999999998913,0.38461538461538464,4,3,19,26,17,9,9,16,10,2,0.1,"[0, 20, 40]",0.0003,0.001,0.0015,1
2524,0.004799999999998109,0.3484848484848485,11,8,47,66,48,18,9,16,10,2,0.1,"[0, 20, 40]",0.0003,0.001,0.0015,3
2525,0.007959999999997485,0.38095238095238093,15,9,60,84,65,19,9,16,10,2,0.1,"[0, 20, 40]",0.0003,0.001,0.0015,5
2526,0.004359999999998895,0.4230769230769231,2,5,19,26,17,9,9,16,10,2,0.1,"[0, 20, 40]",0.0003,0.0015,0.001,1
2527,0.003839999999997932,0.3787878787878788,2,11,53,66,48,18,9,16,10,2,0.1,"[0, 20, 40]",0.0003,0.0015,0.001,3
2528,0.008459999999996937,0.4166666666666667,2,15,67,84,65,19,9,16,10,2,0.1,"[0, 20, 40]",0.0003,0.0015,0.001,5
2529,0.004259999999998851,0.34615384615384615,2,3,21,26,17,9,9,16,10,2,0.1,"[0, 20, 40]",0.0003,0.0015,0.0015,1
2530,0.004079999999997838,0.3333333333333333,2,8,56,66,48,18,9,16,10,2,0.1,"[0, 20, 40]",0.0003,0.0015,0.0015,3
2531,0.006059999999996591,0.35714285714285715,2,9,73,84,65,19,9,16,10,2,0.1,"[0, 20, 40]",0.0003,0.0015,0.0015,5
2532,0.004799999999999004,0.4230769230769231,1,5,20,26,17,9,9,16,10,2,0.1,"[0, 20, 40]",0.0003,0.002,0.001,1
2533,0.00427999999999804,0.3787878787878788,1,11,54,66,48,18,9,16,10,2,0.1,"[0, 20, 40]",0.0003,0.002,0.001,3
2534,0.008899999999997046,0.4166666666666667,1,15,68,84,65,19,9,16,10,2,0.1,"[0, 20, 40]",0.0003,0.002,0.001,5
2535,0.004699999999998959,0.34615384615384615,1,3,22,26,17,9,9,16,10,2,0.1,"[0, 20, 40]",0.0003,0.002,0.0015,1
2536,0.004519999999997946,0.3333333333333333,1,8,57,66,48,18,9,16,10,2,0.1,"[0, 20, 40]",0.0003,0.002,0.0015,3
2537,0.006499999999996698,0.35714285714285715,1,9,74,84,65,19,9,16,10,2,0.1,"[0, 20, 40]",0.0003,0.002,0.0015,5
2538,0.003609999999999999,0.6,3,2,5,10,7,3,9,16,10,2,0.1,"[0, 20, 40]",0.0005,0.001,0.001,1
2539,0.010159999999999673,0.5625,8,8,16,32,26,6,9,16,10,2,0.1,"[0, 20, 40]",0.0005,0.001,0.001,3
2540,0.015069999999998931,0.5714285714285714,13,10,26,49,43,6,9,16,10,2,0.1,"[0, 20, 40]",0.0005,0.001,0.001,5
2541,0.0018099999999999202,0.5,3,1,6,10,7,3,9,16,10,2,0.1,"[0, 20, 40]",0.0005,0.001,0.0015,1
2542,0.00885999999999948,0.5,8,6,18,32,26,6,9,16,10,2,0.1,"[0, 20, 40]",0.0005,0.001,0.0015,3
2543,0.01282999999999852,0.5102040816326531,13,7,29,49,43,6,9,16,10,2,0.1,"[0, 20, 40]",0.0005,0.001,0.0015,5
2544,0.0023799999999997695,0.4,1,2,7,10,7,3,9,16,10,2,0.1,"[0, 20, 40]",0.0005,0.0015,0.001,1
2545,0.010129999999999311,0.5,3,8,21,32,26,6,9,16,10,2,0.1,"[0, 20, 40]",0.0005,0.0015,0.001,3
2546,0.01662999999999788,0.5306122448979592,5,10,34,49,43,6,9,16,10,2,0.1,"[0, 20, 40]",0.0005,0.0015,0.001,5
2547,0.0005799999999996909,0.3,1,1,8,10,7,3,9,16,10,2,0.1,"[0, 20, 40]",0.0005,0.0015,0.0015,1
2548,0.008829999999999118,0.4375,3,6,23,32,26,6,9,16,10,2,0.1,"[0, 20, 40]",0.0005,0.0015,0.0015,3
2549,0.014389999999997469,0.46938775510204084,5,7,37,49,43,6,9,16,10,2,0.1,"[0, 20, 40]",0.0005,0.0015,0.0015,5
2550,0.0028799999999997695,0.4,1,2,7,10,7,3,9,16,10,2,0.1,"[0, 20, 40]",0.0005,0.002,0.001,1
2551,0.010309999999999103,0.5,2,8,22,32,26,6,9,16,10,2,0.1,"[0, 20, 40]",0.0005,0.002,0.001,3
2552,0.016849999999997606,0.5306122448979592,3,10,36,49,43,6,9,16,10,2,0.1,"[0, 20, 40]",0.0005,0.002,0.001,5
2553,0.001079999999999691,0.3,1,1,8,10,7,3,9,16,10,2,0.1,"[0, 20, 40]",0.0005,0.002,0.0015,1
2554,0.009009999999998911,0.4375,2,6,24,32,26,6,9,16,10,2,0.1,"[0, 20, 40]",0.0005,0.002,0.0015,3
2555,0.01460999999999719,0.46938775510204084,3,7,39,49,43,6,9,16,10,2,0.1,"[0, 20, 40]",0.0005,0.002,0.0015,5
2556,0.003129999999999697,0.5833333333333334,3,2,7,12,11,1,9,16,10,2,0.2,"[0, 20, 40]",0.0003,0.001,0.001,1
2557,0.0012999999999996313,0.4,5,5,20,30,26,4,9,16,10,2,0.2,"[0, 20, 40]",0.0003,0.001,0.001,3
2558,0.007069999999999085,0.5,6,9,27,42,37,5,9,16,10,2,0.2,"[0, 20, 40]",0.0003,0.001,0.001,5
2559,0.004129999999999697,0.5833333333333334,3,2,7,12,11,1,9,16,10,2,0.2,"[0, 20, 40]",0.0003,0.001,0.0015,1
2560,0.00113999999999958,0.36666666666666664,5,4,21,30,26,4,9,16,10,2,0.2,"[0, 20, 40]",0.0003,0.001,0.0015,3
2561,0.004009999999998962,0.42857142857142855,7,5,30,42,37,5,9,16,10,2,0.2,"[0, 20, 40]",0.0003,0.001,0.0015,5
2562,0.0030799999999997583,0.5833333333333334,1,3,8,12,11,1,9,16,10,2,0.2,"[0, 20, 40]",0.0003,0.0015,0.001,1
2563,0.0013799999999996578,0.4,1,6,23,30,26,4,9,16,10,2,0.2,"[0, 20, 40]",0.0003,0.0015,0.001,3
2564,0.005889999999998961,0.47619047619047616,1,10,31,42,37,5,9,16,10,2,0.2,"[0, 20, 40]",0.0003,0.0015,0.001,5
2565,0.0033999999999996342,0.5,1,2,9,12,11,1,9,16,10,2,0.2,"[0, 20, 40]",0.0003,0.0015,0.0015,1
2566,0.0005399999999994825,0.3333333333333333,1,4,25,30,26,4,9,16,10,2,0.2,"[0, 20, 40]",0.0003,0.0015,0.0015,3
2567,0.0024099999999985335,0.38095238095238093,1,5,36,42,37,5,9,16,10,2,0.2,"[0, 20, 40]",0.0003,0.0015,0.0015,5
2568,0.003019999999999866,0.5833333333333334,0,3,9,12,11,1,9,16,10,2,0.2,"[0, 20, 40]",0.0003,0.002,0.001,1
2569,0.0013199999999997656,0.4,0,6,24,30,26,4,9,16,10,2,0.2,"[0, 20, 40]",0.0003,0.002,0.001,3
2570,0.005829999999999069,0.47619047619047616,0,10,32,42,37,5,9,16,10,2,0.2,"[0, 20, 40]",0.0003,0.002,0.001,5
2571,0.0033399999999997416,0.5,0,2,10,12,11,1,9,16,10,2,0.2,"[0, 20, 40]",0.0003,0.002,0.0015,1
2572,0.00047999999999959035,0.3333333333333333,0,4,26,30,26,4,9,16,10,2,0.2,"[0, 20, 40]",0.0003,0.002,0.0015,3
2573,0.0023499999999986414,0.38095238095238093,0,5,37,42,37,5,9,16,10,2,0.2,"[0, 20, 40]",0.0003,0.002,0.0015,5
2574,0.0006499999999998396,0.5,0,1,3,4,4,0,9,16,10,2,0.2,"[0, 20, 40]",0.0005,0.001,0.001,1
2575,0.002059999999999815,0.4375,2,4,10,16,15,1,9,16,10,2,0.2,"[0, 20, 40]",0.0005,0.001,0.001,3
2576,0.005439999999999398,0.5185185185185185,5,6,16,27,26,1,9,16,10,2,0.2,"[0, 20, 40]",0.0005,0.001,0.001,5
2577,0.001149999999999839,0.5,0,1,3,4,4,0,9,16,10,2,0.2,"[0, 20, 40]",0.0005,0.001,0.0015,1
2578,0.0015599999999997025,0.375,2,3,11,16,15,1,9,16,10,2,0.2,"[0, 20, 40]",0.0005,0.001,0.0015,3
2579,0.003999999999999065,0.4444444444444444,5,4,18,27,26,1,9,16,10,2,0.2,"[0, 20, 40]",0.0005,0.001,0.0015,5
2580,0.0006499999999998396,0.5,0,1,3,4,4,0,9,16,10,2,0.2,"[0, 20, 40]",0.0005,0.0015,0.001,1
2581,0.002519999999999664,0.4375,1,4,11,16,15,1,9,16,10,2,0.2,"[0, 20, 40]",0.0005,0.0015,0.001,3
2582,0.006489999999998564,0.5185185185185185,1,6,20,27,26,1,9,16,10,2,0.2,"[0, 20, 40]",0.0005,0.0015,0.001,5
2583,0.001149999999999839,0.5,0,1,3,4,4,0,9,16,10,2,0.2,"[0, 20, 40]",0.0005,0.0015,0.0015,1
2584,0.002019999999999552,0.375,1,3,12,16,15,1,9,16,10,2,0.2,"[0, 20, 40]",0.0005,0.0015,0.0015,3
2585,0.005049999999998231,0.4444444444444444,1,4,22,27,26,1,9,16,10,2,0.2,"[0, 20, 40]",0.0005,0.0015,0.0015,5
2586,0.0006499999999998396,0.5,0,1,3,4,4,0,9,16,10,2,0.2,"[0, 20, 40]",0.0005,0.002,0.001,1
2587,0.0030199999999996644,0.4375,1,4,11,16,15,1,9,16,10,2,0.2,"[0, 20, 40]",0.0005,0.002,0.001,3
2588,0.006989999999998563,0.5185185185185185,1,6,20,27,26,1,9,16,10,2,0.2,"[0, 20, 40]",0.0005,0.002,0.001,5
2589,0.001149999999999839,0.5,0,1,3,4,4,0,9,16,10,2,0.2,"[0, 20, 40]",0.0005,0.002,0.0015,1
2590,0.0025199999999995517,0.375,1,3,12,16,15,1,9,16,10,2,0.2,"[0, 20, 40]",0.0005,0.002,0.0015,3
2591,0.005549999999998232,0.4444444444444444,1,4,22,27,26,1,9,16,10,2,0.2,"[0, 20, 40]",0.0005,0.002,0.0015,5
2592,0.010969999999998807,0.6285714285714286,9,10,16,35,20,15,9,16,15,1,0.1,"[0, 20, 40]",0.0003,0.001,0.001,1
2593,0.02098999999999751,0.569620253164557,18,21,40,79,49,30,9,16,15,1,0.1,"[0, 20, 40]",0.0003,0.001,0.001,3
2594,0.02800999999999694,0.57,23,25,52,100,67,33,9,16,15,1,0.1,"[0, 20, 40]",0.0003,0.001,0.001,5
2595,0.003499999999998665,0.4857142857142857,10,3,22,35,20,15,9,16,15,1,0.1,"[0, 20, 40]",0.0003,0.001,0.0015,1
2596,0.01059999999999706,0.45569620253164556,19,10,50,79,49,30,9,16,15,1,0.1,"[0, 20, 40]",0.0003,0.001,0.0015,3
2597,0.016459999999996672,0.47,25,12,63,100,67,33,9,16,15,1,0.1,"[0, 20, 40]",0.0003,0.001,0.0015,5
2598,0.013499999999998558,0.6285714285714286,5,12,18,35,20,15,9,16,15,1,0.1,"[0, 20, 40]",0.0003,0.0015,0.001,1
2599,0.024039999999996998,0.5569620253164557,9,23,47,79,49,30,9,16,15,1,0.1,"[0, 20, 40]",0.0003,0.0015,0.001,3
2600,0.029079999999996255,0.55,9,27,64,100,67,33,9,16,15,1,0.1,"[0, 20, 40]",0.0003,0.0015,0.001,5
2601,0.0070299999999983084,0.4857142857142857,7,3,25,35,20,15,9,16,15,1,0.1,"[0, 20, 40]",0.0003,0.0015,0.0015,1
2602,0.014649999999996442,0.4430379746835443,11,10,58,79,49,30,9,16,15,1,0.1,"[0, 20, 40]",0.0003,0.0015,0.0015,3
2603,0.019029999999995873,0.45,12,12,76,100,67,33,9,16,15,1,0.1,"[0, 20, 40]",0.0003,0.0015,0.0015,5
2604,0.01352999999999859,0.6,3,12,20,35,20,15,9,16,15,1,0.1,"[0, 20, 40]",0.0003,0.002,0.001,1
2605,0.025459999999997034,0.5443037974683544,6,23,50,79,49,30,9,16,15,1,0.1,"[0, 20, 40]",0.0003,0.002,0.001,3
2606,0.030499999999996294,0.54,6,27,67,100,67,33,9,16,15,1,0.1,"[0, 20, 40]",0.0003,0.002,0.001,5
2607,0.00747999999999854,0.45714285714285713,3,3,29,35,20,15,9,16,15,1,0.1,"[0, 20, 40]",0.0003,0.002,0.0015,1
2608,0.016489999999996674,0.43037974683544306,6,10,63,79,49,30,9,16,15,1,0.1,"[0, 20, 40]",0.0003,0.002,0.0015,3
2609,0.021369999999996125,0.44,7,12,81,100,67,33,9,16,15,1,0.1,"[0, 20, 40]",0.0003,0.002,0.0015,5
2610,0.005549999999999874,0.875,5,2,1,8,4,4,9,16,15,1,0.1,"[0, 20, 40]",0.0005,0.001,0.001,1
2611,0.018409999999999066,0.7368421052631579,13,12,13,38,25,13,9,16,15,1,0.1,"[0, 20, 40]",0.0005,0.001,0.001,3
2612,0.02273999999999836,0.6666666666666666,19,14,24,57,43,14,9,16,15,1,0.1,"[0, 20, 40]",0.0005,0.001,0.001,5
2613,0.0032499999999997934,0.75,6,0,2,8,4,4,9,16,15,1,0.1,"[0, 20, 40]",0.0005,0.001,0.0015,1
2614,0.011909999999998897,0.6052631578947368,14,6,18,38,25,13,9,16,15,1,0.1,"[0, 20, 40]",0.0005,0.001,0.0015,3
2615,0.017239999999998198,0.5789473684210527,20,8,29,57,43,14,9,16,15,1,0.1,"[0, 20, 40]",0.0005,0.001,0.0015,5
2616,0.0032099999999997005,0.625,1,2,5,8,4,4,9,16,15,1,0.1,"[0, 20, 40]",0.0005,0.0015,0.001,1
2617,0.018459999999998734,0.6842105263157895,6,12,20,38,25,13,9,16,15,1,0.1,"[0, 20, 40]",0.0005,0.0015,0.001,3
2618,0.025449999999997853,0.631578947368421,11,14,32,57,43,14,9,16,15,1,0.1,"[0, 20, 40]",0.0005,0.0015,0.001,5
2619,0.0014099999999996212,0.5,2,0,6,8,4,4,9,16,15,1,0.1,"[0, 20, 40]",0.0005,0.0015,0.0015,1
2620,0.01245999999999856,0.5526315789473685,7,6,25,38,25,13,9,16,15,1,0.1,"[0, 20, 40]",0.0005,0.0015,0.0015,3
2621,0.020449999999997685,0.543859649122807,12,8,37,57,43,14,9,16,15,1,0.1,"[0, 20, 40]",0.0005,0.0015,0.0015,5
2622,0.0037099999999997005,0.625,1,2,5,8,4,4,9,16,15,1,0.1,"[0, 20, 40]",0.0005,0.002,0.001,1
2623,0.019729999999998724,0.6842105263157895,4,12,22,38,25,13,9,16,15,1,0.1,"[0, 20, 40]",0.0005,0.002,0.001,3
2624,0.026299999999997596,0.6140350877192983,6,14,37,57,43,14,9,16,15,1,0.1,"[0, 20, 40]",0.0005,0.002,0.001,5
2625,0.002409999999999621,0.5,2,0,6,8,4,4,9,16,15,1,0.1,"[0, 20, 40]",0.0005,0.002,0.0015,1
2626,0.014229999999998553,0.5526315789473685,5,6,27,38,25,13,9,16,15,1,0.1,"[0, 20, 40]",0.0005,0.002,0.0015,3
2627,0.021799999999997436,0.5263157894736842,7,8,42,57,43,14,9,16,15,1,0.1,"[0, 20, 40]",0.0005,0.002,0.0015,5
2628,0.0043999999999993775,0.625,5,3,8,16,13,3,9,16,15,1,0.2,"[0, 20, 40]",0.0003,0.001,0.001,1
2629,0.0052899999999984565,0.4857142857142857,7,6,22,35,28,7,9,16,15,1,0.2,"[0, 20, 40]",0.0003,0.001,0.001,3
2630,0.010439999999998426,0.5217391304347826,10,9,27,46,38,8,9,16,15,1,0.2,"[0, 20, 40]",0.0003,0.001,0.001,5
2631,0.0016599999999994694,0.5,5,1,10,16,13,3,9,16,15,1,0.2,"[0, 20, 40]",0.0003,0.001,0.0015,1
2632,0.002039999999998316,0.4,7,3,25,35,28,7,9,16,15,1,0.2,"[0, 20, 40]",0.0003,0.001,0.0015,3
2633,0.006029999999998454,0.43478260869565216,10,5,31,46,38,8,9,16,15,1,0.2,"[0, 20, 40]",0.0003,0.001,0.0015,5
2634,0.006399999999999378,0.625,4,4,8,16,13,3,9,16,15,1,0.2,"[0, 20, 40]",0.0003,0.0015,0.001,1
2635,0.00750999999999835,0.4857142857142857,4,7,24,35,28,7,9,16,15,1,0.2,"[0, 20, 40]",0.0003,0.0015,0.001,3
2636,0.01095999999999817,0.5,4,10,32,46,38,8,9,16,15,1,0.2,"[0, 20, 40]",0.0003,0.0015,0.001,5
2637,0.0036599999999993586,0.5,4,1,11,16,13,3,9,16,15,1,0.2,"[0, 20, 40]",0.0003,0.0015,0.0015,1
2638,0.0042599999999980934,0.4,4,3,28,35,28,7,9,16,15,1,0.2,"[0, 20, 40]",0.0003,0.0015,0.0015,3
2639,0.006549999999998086,0.41304347826086957,4,5,37,46,38,8,9,16,15,1,0.2,"[0, 20, 40]",0.0003,0.0015,0.0015,5
2640,0.00592999999999941,0.5625,2,4,10,16,13,3,9,16,15,1,0.2,"[0, 20, 40]",0.0003,0.002,0.001,1
2641,0.007039999999998379,0.45714285714285713,2,7,26,35,28,7,9,16,15,1,0.2,"[0, 20, 40]",0.0003,0.002,0.001,3
2642,0.010489999999998202,0.4782608695652174,2,10,34,46,38,8,9,16,15,1,0.2,"[0, 20, 40]",0.0003,0.002,0.001,5
2643,0.00318999999999939,0.4375,2,1,13,16,13,3,9,16,15,1,0.2,"[0, 20, 40]",0.0003,0.002,0.0015,1
2644,0.0037899999999981243,0.37142857142857144,2,3,30,35,28,7,9,16,15,1,0.2,"[0, 20, 40]",0.0003,0.002,0.0015,3
2645,0.006079999999998117,0.391304347826087,2,5,39,46,38,8,9,16,15,1,0.2,"[0, 20, 40]",0.0003,0.002,0.0015,5
2646,0.0023499999999998726,0.75,3,0,1,4,3,1,9,16,15,1,0.2,"[0, 20, 40]",0.0005,0.001,0.001,1
2647,0.007779999999999317,0.6190476190476191,6,5,10,21,18,3,9,16,15,1,0.2,"[0, 20, 40]",0.0005,0.001,0.001,3
2648,0.00952999999999879,0.5483870967741935,8,7,16,31,28,3,9,16,15,1,0.2,"[0, 20, 40]",0.0005,0.001,0.001,5
2649,0.0023499999999998726,0.75,3,0,1,4,3,1,9,16,15,1,0.2,"[0, 20, 40]",0.0005,0.001,0.0015,1
2650,0.005999999999999146,0.5238095238095238,6,3,12,21,18,3,9,16,15,1,0.2,"[0, 20, 40]",0.0005,0.001,0.0015,3
2651,0.008749999999998617,0.4838709677419355,8,5,18,31,28,3,9,16,15,1,0.2,"[0, 20, 40]",0.0005,0.001,0.0015,5
2652,0.001099999999999512,0.5,1,0,3,4,3,1,9,16,15,1,0.2,"[0, 20, 40]",0.0005,0.0015,0.001,1
2653,0.007779999999998928,0.5714285714285714,3,5,13,21,18,3,9,16,15,1,0.2,"[0, 20, 40]",0.0005,0.0015,0.001,3
2654,0.01018999999999823,0.5161290322580645,4,7,20,31,28,3,9,16,15,1,0.2,"[0, 20, 40]",0.0005,0.0015,0.001,5
2655,0.001099999999999512,0.5,1,0,3,4,3,1,9,16,15,1,0.2,"[0, 20, 40]",0.0005,0.0015,0.0015,1
2656,0.005999999999998756,0.47619047619047616,3,3,15,21,18,3,9,16,15,1,0.2,"[0, 20, 40]",0.0005,0.0015,0.0015,3
2657,0.009409999999998057,0.45161290322580644,4,5,22,31,28,3,9,16,15,1,0.2,"[0, 20, 40]",0.0005,0.0015,0.0015,5
2658,0.001599999999999512,0.5,1,0,3,4,3,1,9,16,15,1,0.2,"[0, 20, 40]",0.0005,0.002,0.001,1
2659,0.00754999999999892,0.5714285714285714,1,5,15,21,18,3,9,16,15,1,0.2,"[0, 20, 40]",0.0005,0.002,0.001,3
2660,0.009639999999998185,0.5161290322580645,1,7,23,31,28,3,9,16,15,1,0.2,"[0, 20, 40]",0.0005,0.002,0.001,5
2661,0.001599999999999512,0.5,1,0,3,4,3,1,9,16,15,1,0.2,"[0, 20, 40]",0.0005,0.002,0.0015,1
2662,0.00576999999999875,0.47619047619047616,1,3,17,21,18,3,9,16,15,1,0.2,"[0, 20, 40]",0.0005,0.002,0.0015,3
2663,0.008859999999998012,0.45161290322580644,1,5,25,31,28,3,9,16,15,1,0.2,"[0, 20, 40]",0.0005,0.002,0.0015,5
2664,0.0011599999999992922,0.4166666666666667,5,3,16,24,15,9,9,16,15,2,0.1,"[0, 20, 40]",0.0003,0.001,0.001,1
2665,0.008089999999998192,0.4603174603174603,13,12,38,63,45,18,9,16,15,2,0.1,"[0, 20, 40]",0.0003,0.001,0.001,3
2666,0.014349999999997965,0.4875,17,16,47,80,61,19,9,16,15,2,0.1,"[0, 20, 40]",0.0003,0.001,0.001,5
2667,0.0015799999999993792,0.4166666666666667,5,2,17,24,15,9,9,16,15,2,0.1,"[0, 20, 40]",0.0003,0.001,0.0015,1
2668,0.008569999999997947,0.42857142857142855,13,9,41,63,45,18,9,16,15,2,0.1,"[0, 20, 40]",0.0003,0.001,0.0015,3
2669,0.013669999999997883,0.45,18,11,51,80,61,19,9,16,15,2,0.1,"[0, 20, 40]",0.0003,0.001,0.0015,5
2670,0.0021899999999990464,0.4166666666666667,2,4,18,24,15,9,9,16,15,2,0.1,"[0, 20, 40]",0.0003,0.0015,0.001,1
2671,0.010219999999997608,0.4444444444444444,6,13,44,63,45,18,9,16,15,2,0.1,"[0, 20, 40]",0.0003,0.0015,0.001,3
2672,0.014719999999997171,0.4625,6,17,57,80,61,19,9,16,15,2,0.1,"[0, 20, 40]",0.0003,0.0015,0.001,5
2673,0.002609999999999023,0.4166666666666667,2,2,20,24,15,9,9,16,15,2,0.1,"[0, 20, 40]",0.0003,0.0015,0.0015,1
2674,0.010699999999997245,0.4126984126984127,6,9,48,63,45,18,9,16,15,2,0.1,"[0, 20, 40]",0.0003,0.0015,0.0015,3
2675,0.014539999999996977,0.425,7,11,62,80,61,19,9,16,15,2,0.1,"[0, 20, 40]",0.0003,0.0015,0.0015,5
2676,0.003189999999999046,0.4166666666666667,2,4,18,24,15,9,9,16,15,2,0.1,"[0, 20, 40]",0.0003,0.002,0.001,1
2677,0.012609999999997604,0.4444444444444444,5,13,45,63,45,18,9,16,15,2,0.1,"[0, 20, 40]",0.0003,0.002,0.001,3
2678,0.01710999999999717,0.4625,5,17,58,80,61,19,9,16,15,2,0.1,"[0, 20, 40]",0.0003,0.002,0.001,5
2679,0.003609999999999023,0.4166666666666667,2,2,20,24,15,9,9,16,15,2,0.1,"[0, 20, 40]",0.0003,0.002,0.0015,1
2680,0.013089999999997238,0.4126984126984127,5,9,49,63,45,18,9,16,15,2,0.1,"[0, 20, 40]",0.0003,0.002,0.0015,3
2681,0.017429999999996983,0.425,6,11,63,80,61,19,9,16,15,2,0.1,"[0, 20, 40]",0.0003,0.002,0.0015,5
2682,0.004359999999999938,0.6666666666666666,5,1,3,9,6,3,9,16,15,2,0.1,"[0, 20, 40]",0.0005,0.001,0.001,1
2683,0.015119999999999327,0.7096774193548387,11,9,11,31,25,6,9,16,15,2,0.1,"[0, 20, 40]",0.0005,0.001,0.001,3
2684,0.02063999999999869,0.6666666666666666,17,11,20,48,42,6,9,16,15,2,0.1,"[0, 20, 40]",0.0005,0.001,0.001,5
2685,0.0020599999999998593,0.5555555555555556,5,0,4,9,6,3,9,16,15,2,0.1,"[0, 20, 40]",0.0005,0.001,0.0015,1
2686,0.012129999999999051,0.6129032258064516,11,6,14,31,25,6,9,16,15,2,0.1,"[0, 20, 40]",0.0005,0.001,0.0015,3
2687,0.018649999999998418,0.6041666666666666,17,8,23,48,42,6,9,16,15,2,0.1,"[0, 20, 40]",0.0005,0.001,0.0015,5
2688,0.002019999999999766,0.4444444444444444,1,1,7,9,6,3,9,16,15,2,0.1,"[0, 20, 40]",0.0005,0.0015,0.001,1
2689,0.014169999999998987,0.6451612903225806,4,9,18,31,25,6,9,16,15,2,0.1,"[0, 20, 40]",0.0005,0.0015,0.001,3
2690,0.02234999999999818,0.625,9,11,28,48,42,6,9,16,15,2,0.1,"[0, 20, 40]",0.0005,0.0015,0.001,5
2691,-0.0002800000000003134,0.3333333333333333,1,0,8,9,6,3,9,16,15,2,0.1,"[0, 20, 40]",0.0005,0.0015,0.0015,1
2692,0.011179999999998714,0.5483870967741935,4,6,21,31,25,6,9,16,15,2,0.1,"[0, 20, 40]",0.0005,0.0015,0.0015,3
2693,0.020359999999997914,0.5625,9,8,31,48,42,6,9,16,15,2,0.1,"[0, 20, 40]",0.0005,0.0015,0.0015,5
2694,0.002519999999999766,0.4444444444444444,1,1,7,9,6,3,9,16,15,2,0.1,"[0, 20, 40]",0.0005,0.002,0.001,1
2695,0.015569999999999052,0.6451612903225806,3,9,19,31,25,6,9,16,15,2,0.1,"[0, 20, 40]",0.0005,0.002,0.001,3
2696,0.023329999999997995,0.6041666666666666,5,11,32,48,42,6,9,16,15,2,0.1,"[0, 20, 40]",0.0005,0.002,0.001,5
2697,0.0002199999999996866,0.3333333333333333,1,0,8,9,6,3,9,16,15,2,0.1,"[0, 20, 40]",0.0005,0.002,0.0015,1
2698,0.012579999999998781,0.5483870967741935,3,6,22,31,25,6,9,16,15,2,0.1,"[0, 20, 40]",0.0005,0.002,0.0015,3
2699,0.021339999999997732,0.5416666666666666,5,8,35,48,42,6,9,16,15,2,0.1,"[0, 20, 40]",0.0005,0.002,0.0015,5
2700,0.0016799999999999023,0.5,3,1,6,10,9,1,9,16,15,2,0.2,"[0, 20, 40]",0.0003,0.001,0.001,1
2701,0.0041599999999994254,0.4642857142857143,5,6,17,28,24,4,9,16,15,2,0.2,"[0, 20, 40]",0.0003,0.001,0.001,3
2702,0.009969999999999275,0.5384615384615384,7,10,22,39,34,5,9,16,15,2,0.2,"[0, 20, 40]",0.0003,0.001,0.001,5
2703,0.0021799999999999016,0.5,3,1,6,10,9,1,9,16,15,2,0.2,"[0, 20, 40]",0.0003,0.001,0.0015,1
2704,0.002719999999999095,0.39285714285714285,5,4,19,28,24,4,9,16,15,2,0.2,"[0, 20, 40]",0.0003,0.001,0.0015,3
2705,0.007369999999999115,0.46153846153846156,8,6,25,39,34,5,9,16,15,2,0.2,"[0, 20, 40]",0.0003,0.001,0.0015,5
2706,0.0022299999999996754,0.5,1,2,7,10,9,1,9,16,15,2,0.2,"[0, 20, 40]",0.0003,0.0015,0.001,1
2707,0.004189999999999068,0.42857142857142855,2,7,19,28,24,4,9,16,15,2,0.2,"[0, 20, 40]",0.0003,0.0015,0.001,3
2708,0.008319999999999014,0.48717948717948717,2,11,26,39,34,5,9,16,15,2,0.2,"[0, 20, 40]",0.0003,0.0015,0.001,5
2709,0.002729999999999565,0.5,1,1,8,10,9,1,9,16,15,2,0.2,"[0, 20, 40]",0.0003,0.0015,0.0015,1
2710,0.0027499999999986272,0.35714285714285715,2,4,22,28,24,4,9,16,15,2,0.2,"[0, 20, 40]",0.0003,0.0015,0.0015,3
2711,0.006219999999998743,0.41025641025641024,3,6,30,39,34,5,9,16,15,2,0.2,"[0, 20, 40]",0.0003,0.0015,0.0015,5
2712,0.0027299999999996754,0.5,1,2,7,10,9,1,9,16,15,2,0.2,"[0, 20, 40]",0.0003,0.002,0.001,1
2713,0.005189999999999069,0.42857142857142855,2,7,19,28,24,4,9,16,15,2,0.2,"[0, 20, 40]",0.0003,0.002,0.001,3
2714,0.009319999999999015,0.48717948717948717,2,11,26,39,34,5,9,16,15,2,0.2,"[0, 20, 40]",0.0003,0.002,0.001,5
2715,0.003229999999999565,0.5,1,1,8,10,9,1,9,16,15,2,0.2,"[0, 20, 40]",0.0003,0.002,0.0015,1
2716,0.003749999999998627,0.35714285714285715,2,4,22,28,24,4,9,16,15,2,0.2,"[0, 20, 40]",0.0003,0.002,0.0015,3
2717,0.007719999999998745,0.41025641025641024,3,6,30,39,34,5,9,16,15,2,0.2,"[0, 20, 40]",0.0003,0.002,0.0015,5
2718,0.0005499999999998725,0.3333333333333333,1,0,2,3,3,0,9,16,15,2,0.2,"[0, 20, 40]",0.0005,0.001,0.001,1
2719,0.005249999999999531,0.6,3,4,8,15,14,1,9,16,15,2,0.2,"[0, 20, 40]",0.0005,0.001,0.001,3
2720,0.008889999999999149,0.5769230769230769,7,6,13,26,25,1,9,16,15,2,0.2,"[0, 20, 40]",0.0005,0.001,0.001,5
2721,0.0005499999999998725,0.3333333333333333,1,0,2,3,3,0,9,16,15,2,0.2,"[0, 20, 40]",0.0005,0.001,0.0015,1
2722,0.005439999999999275,0.5333333333333333,3,3,9,15,14,1,9,16,15,2,0.2,"[0, 20, 40]",0.0005,0.001,0.0015,3
2723,0.010079999999998892,0.5384615384615384,7,5,14,26,25,1,9,16,15,2,0.2,"[0, 20, 40]",0.0005,0.001,0.0015,5
2724,0.0004999999999996569,0.3333333333333333,0,0,3,3,3,0,9,16,15,2,0.2,"[0, 20, 40]",0.0005,0.0015,0.001,1
2725,0.0059499999999992875,0.6,1,4,10,15,14,1,9,16,15,2,0.2,"[0, 20, 40]",0.0005,0.0015,0.001,3
2726,0.011249999999998733,0.5769230769230769,4,6,16,26,25,1,9,16,15,2,0.2,"[0, 20, 40]",0.0005,0.0015,0.001,5
2727,0.0004999999999996569,0.3333333333333333,0,0,3,3,3,0,9,16,15,2,0.2,"[0, 20, 40]",0.0005,0.0015,0.0015,1
2728,0.006139999999999032,0.5333333333333333,1,3,11,15,14,1,9,16,15,2,0.2,"[0, 20, 40]",0.0005,0.0015,0.0015,3
2729,0.012439999999998477,0.5384615384615384,4,5,17,26,25,1,9,16,15,2,0.2,"[0, 20, 40]",0.0005,0.0015,0.0015,5
2730,0.0004999999999996569,0.3333333333333333,0,0,3,3,3,0,9,16,15,2,0.2,"[0, 20, 40]",0.0005,0.002,0.001,1
2731,0.006449999999999288,0.6,1,4,10,15,14,1,9,16,15,2,0.2,"[0, 20, 40]",0.0005,0.002,0.001,3
2732,0.012169999999998547,0.5769230769230769,2,6,18,26,25,1,9,16,15,2,0.2,"[0, 20, 40]",0.0005,0.002,0.001,5
2733,0.0004999999999996569,0.3333333333333333,0,0,3,3,3,0,9,16,15,2,0.2,"[0, 20, 40]",0.0005,0.002,0.0015,1
2734,0.006639999999999032,0.5333333333333333,1,3,11,15,14,1,9,16,15,2,0.2,"[0, 20, 40]",0.0005,0.002,0.0015,3
2735,0.013359999999998286,0.5384615384615384,2,5,19,26,25,1,9,16,15,2,0.2,"[0, 20, 40]",0.0005,0.002,0.0015,5
2736,0.012560000000000028,0.7058823529411765,12,12,10,34,20,14,9,16,20,1,0.1,"[0, 20, 40]",0.0003,0.001,0.001,1
2737,0.027299999999999908,0.6944444444444444,23,24,25,72,46,26,9,16,20,1,0.1,"[0, 20, 40]",0.0003,0.001,0.001,3
2738,0.03634999999999958,0.6956521739130435,31,29,32,92,63,29,9,16,20,1,0.1,"[0, 20, 40]",0.0003,0.001,0.001,5
2739,0.010570000000000034,0.5882352941176471,13,7,14,34,20,14,9,16,20,1,0.1,"[0, 20, 40]",0.0003,0.001,0.0015,1
2740,0.019149999999999934,0.5555555555555556,23,14,35,72,46,26,9,16,20,1,0.1,"[0, 20, 40]",0.0003,0.001,0.0015,3
2741,0.03081999999999965,0.5978260869565217,32,18,42,92,62,30,9,16,20,1,0.1,"[0, 20, 40]",0.0003,0.001,0.0015,5
2742,0.01567999999999987,0.7058823529411765,7,14,13,34,20,14,9,16,20,1,0.1,"[0, 20, 40]",0.0003,0.0015,0.001,1
2743,0.02955999999999923,0.6527777777777778,11,27,34,72,46,26,9,16,20,1,0.1,"[0, 20, 40]",0.0003,0.0015,0.001,3
2744,0.037389999999998626,0.6413043478260869,14,33,45,92,63,29,9,16,20,1,0.1,"[0, 20, 40]",0.0003,0.0015,0.001,5
2745,0.015189999999999874,0.5882352941176471,10,7,17,34,20,14,9,16,20,1,0.1,"[0, 20, 40]",0.0003,0.0015,0.0015,1
2746,0.022909999999999247,0.5138888888888888,13,15,44,72,46,26,9,16,20,1,0.1,"[0, 20, 40]",0.0003,0.0015,0.0015,3
2747,0.03229999999999859,0.532608695652174,17,19,56,92,62,30,9,16,20,1,0.1,"[0, 20, 40]",0.0003,0.0015,0.0015,5
2748,0.015909999999999546,0.7058823529411765,3,14,17,34,20,14,9,16,20,1,0.1,"[0, 20, 40]",0.0003,0.002,0.001,1
2749,0.031839999999999015,0.6527777777777778,7,27,38,72,46,26,9,16,20,1,0.1,"[0, 20, 40]",0.0003,0.002,0.001,3
2750,0.03759999999999827,0.6373626373626373,7,32,52,91,63,28,9,16,20,1,0.1,"[0, 20, 40]",0.0003,0.002,0.001,5
2751,0.01612999999999971,0.5882352941176471,5,7,22,34,20,14,9,16,20,1,0.1,"[0, 20, 40]",0.0003,0.002,0.0015,1
2752,0.026189999999999027,0.5138888888888888,9,15,48,72,46,26,9,16,20,1,0.1,"[0, 20, 40]",0.0003,0.002,0.0015,3
2753,0.03350999999999823,0.5274725274725275,10,18,63,91,62,29,9,16,20,1,0.1,"[0, 20, 40]",0.0003,0.002,0.0015,5
2754,0.005489999999999924,0.875,5,2,1,8,4,4,9,16,20,1,0.1,"[0, 20, 40]",0.0005,0.001,0.001,1
2755,0.01885999999999964,0.7714285714285715,12,13,10,35,24,11,9,16,20,1,0.1,"[0, 20, 40]",0.0005,0.001,0.001,3
2756,0.026539999999999224,0.7407407407407407,19,17,18,54,42,12,9,16,20,1,0.1,"[0, 20, 40]",0.0005,0.001,0.001,5
2757,0.0038499999999997273,0.75,6,0,2,8,4,4,9,16,20,1,0.1,"[0, 20, 40]",0.0005,0.001,0.0015,1
2758,0.016809999999999305,0.6571428571428571,13,8,14,35,24,11,9,16,20,1,0.1,"[0, 20, 40]",0.0005,0.001,0.0015,3
2759,0.024229999999998808,0.6481481481481481,20,11,23,54,42,12,9,16,20,1,0.1,"[0, 20, 40]",0.0005,0.001,0.0015,5
2760,0.004430000000000031,0.625,1,3,4,8,4,4,9,16,20,1,0.1,"[0, 20, 40]",0.0005,0.0015,0.001,1
2761,0.019579999999999695,0.7142857142857143,6,14,15,35,24,11,9,16,20,1,0.1,"[0, 20, 40]",0.0005,0.0015,0.001,3
2762,0.029099999999999175,0.7037037037037037,11,18,25,54,42,12,9,16,20,1,0.1,"[0, 20, 40]",0.0005,0.0015,0.001,5
2763,0.0014699999999997922,0.375,2,0,6,8,4,4,9,16,20,1,0.1,"[0, 20, 40]",0.0005,0.0015,0.0015,1
2764,0.016209999999999315,0.5714285714285714,7,8,20,35,24,11,9,16,20,1,0.1,"[0, 20, 40]",0.0005,0.0015,0.0015,3
2765,0.02546999999999872,0.5925925925925926,12,11,31,54,42,12,9,16,20,1,0.1,"[0, 20, 40]",0.0005,0.0015,0.0015,5
2766,0.004930000000000032,0.625,1,3,4,8,4,4,9,16,20,1,0.1,"[0, 20, 40]",0.0005,0.002,0.001,1
2767,0.02185999999999964,0.7142857142857143,5,14,16,35,24,11,9,16,20,1,0.1,"[0, 20, 40]",0.0005,0.002,0.001,3
2768,0.03103999999999851,0.7037037037037037,7,18,29,54,42,12,9,16,20,1,0.1,"[0, 20, 40]",0.0005,0.002,0.001,5
2769,0.0024699999999997922,0.375,2,0,6,8,4,4,9,16,20,1,0.1,"[0, 20, 40]",0.0005,0.002,0.0015,1
2770,0.01898999999999926,0.5714285714285714,6,8,21,35,24,11,9,16,20,1,0.1,"[0, 20, 40]",0.0005,0.002,0.0015,3
2771,0.02790999999999805,0.5925925925925926,8,11,35,54,42,12,9,16,20,1,0.1,"[0, 20, 40]",0.0005,0.002,0.0015,5
2772,0.0038700000000000115,0.6875,7,4,5,16,13,3,9,16,20,1,0.2,"[0, 20, 40]",0.0003,0.001,0.001,1
2773,0.008480000000000307,0.6363636363636364,10,9,14,33,26,7,9,16,20,1,0.2,"[0, 20, 40]",0.0003,0.001,0.001,3
2774,0.013960000000000337,0.6511627906976745,14,12,17,43,35,8,9,16,20,1,0.2,"[0, 20, 40]",0.0003,0.001,0.001,5
2775,0.004069999999999822,0.625,7,3,6,16,13,3,9,16,20,1,0.2,"[0, 20, 40]",0.0003,0.001,0.0015,1
2776,0.006950000000000047,0.5454545454545454,10,6,17,33,26,7,9,16,20,1,0.2,"[0, 20, 40]",0.0003,0.001,0.0015,3
2777,0.01393000000000008,0.5813953488372093,14,9,20,43,35,8,9,16,20,1,0.2,"[0, 20, 40]",0.0003,0.001,0.0015,5
2778,0.0059999999999999195,0.6875,5,5,6,16,13,3,9,16,20,1,0.2,"[0, 20, 40]",0.0003,0.0015,0.001,1
2779,0.010819999999999922,0.6363636363636364,5,10,18,33,26,7,9,16,20,1,0.2,"[0, 20, 40]",0.0003,0.0015,0.001,3
2780,0.0167999999999999,0.6511627906976745,7,14,22,43,35,8,9,16,20,1,0.2,"[0, 20, 40]",0.0003,0.0015,0.001,5
2781,0.00669999999999973,0.625,6,3,7,16,13,3,9,16,20,1,0.2,"[0, 20, 40]",0.0003,0.0015,0.0015,1
2782,0.00978999999999967,0.5454545454545454,6,6,21,33,26,7,9,16,20,1,0.2,"[0, 20, 40]",0.0003,0.0015,0.0015,3
2783,0.015709999999999526,0.5581395348837209,8,9,26,43,35,8,9,16,20,1,0.2,"[0, 20, 40]",0.0003,0.0015,0.0015,5
2784,0.005789999999999713,0.6875,2,5,9,16,13,3,9,16,20,1,0.2,"[0, 20, 40]",0.0003,0.002,0.001,1
2785,0.011649999999999862,0.6363636363636364,3,10,20,33,26,7,9,16,20,1,0.2,"[0, 20, 40]",0.0003,0.002,0.001,3
2786,0.015839999999999684,0.6428571428571429,3,13,26,42,35,7,9,16,20,1,0.2,"[0, 20, 40]",0.0003,0.002,0.001,5
2787,0.006989999999999523,0.625,3,3,10,16,13,3,9,16,20,1,0.2,"[0, 20, 40]",0.0003,0.002,0.0015,1
2788,0.011119999999999613,0.5454545454545454,4,6,23,33,26,7,9,16,20,1,0.2,"[0, 20, 40]",0.0003,0.002,0.0015,3
2789,0.014749999999999316,0.5476190476190477,4,8,30,42,35,7,9,16,20,1,0.2,"[0, 20, 40]",0.0003,0.002,0.0015,5
2790,0.0022899999999999236,0.75,3,0,1,4,3,1,9,16,20,1,0.2,"[0, 20, 40]",0.0005,0.001,0.001,1
2791,0.01034999999999972,0.7142857142857143,6,7,8,21,18,3,9,16,20,1,0.2,"[0, 20, 40]",0.0005,0.001,0.001,3
2792,0.014589999999999517,0.7096774193548387,9,10,12,31,28,3,9,16,20,1,0.2,"[0, 20, 40]",0.0005,0.001,0.001,5
2793,0.0022899999999999236,0.75,3,0,1,4,3,1,9,16,20,1,0.2,"[0, 20, 40]",0.0005,0.001,0.0015,1
2794,0.01007999999999956,0.6190476190476191,6,5,10,21,18,3,9,16,20,1,0.2,"[0, 20, 40]",0.0005,0.001,0.0015,3
2795,0.013559999999999262,0.6129032258064516,9,7,15,31,28,3,9,16,20,1,0.2,"[0, 20, 40]",0.0005,0.001,0.0015,5
2796,0.00261999999999981,0.75,1,1,2,4,3,1,9,16,20,1,0.2,"[0, 20, 40]",0.0005,0.0015,0.001,1
2797,0.012179999999999604,0.7142857142857143,4,8,9,21,18,3,9,16,20,1,0.2,"[0, 20, 40]",0.0005,0.0015,0.001,3
2798,0.016259999999999296,0.7096774193548387,5,11,15,31,28,3,9,16,20,1,0.2,"[0, 20, 40]",0.0005,0.0015,0.001,5
2799,0.0007999999999997668,0.5,1,0,3,4,3,1,9,16,20,1,0.2,"[0, 20, 40]",0.0005,0.0015,0.0015,1
2800,0.010089999999999402,0.5714285714285714,4,5,12,21,18,3,9,16,20,1,0.2,"[0, 20, 40]",0.0005,0.0015,0.0015,3
2801,0.013409999999998999,0.5806451612903226,5,7,19,31,28,3,9,16,20,1,0.2,"[0, 20, 40]",0.0005,0.0015,0.0015,5
2802,0.00311999999999981,0.75,1,1,2,4,3,1,9,16,20,1,0.2,"[0, 20, 40]",0.0005,0.002,0.001,1
2803,0.013459999999999552,0.7142857142857143,3,8,10,21,18,3,9,16,20,1,0.2,"[0, 20, 40]",0.0005,0.002,0.001,3
2804,0.016819999999999027,0.7096774193548387,3,11,17,31,28,3,9,16,20,1,0.2,"[0, 20, 40]",0.0005,0.002,0.001,5
2805,0.0012999999999997668,0.5,1,0,3,4,3,1,9,16,20,1,0.2,"[0, 20, 40]",0.0005,0.002,0.0015,1
2806,0.011369999999999351,0.5714285714285714,3,5,13,21,18,3,9,16,20,1,0.2,"[0, 20, 40]",0.0005,0.002,0.0015,3
2807,0.013969999999998728,0.5806451612903226,3,7,21,31,28,3,9,16,20,1,0.2,"[0, 20, 40]",0.0005,0.002,0.0015,5
2808,0.007139999999999962,0.5652173913043478,7,6,10,23,15,8,9,16,20,2,0.1,"[0, 20, 40]",0.0003,0.001,0.001,1
2809,0.01988999999999977,0.603448275862069,16,16,26,58,42,16,9,16,20,2,0.1,"[0, 20, 40]",0.0003,0.001,0.001,3
2810,0.02823999999999968,0.6266666666666667,23,21,31,75,58,17,9,16,20,2,0.1,"[0, 20, 40]",0.0003,0.001,0.001,5
2811,0.008800000000000122,0.5217391304347826,7,5,11,23,15,8,9,16,20,2,0.1,"[0, 20, 40]",0.0003,0.001,0.0015,1
2812,0.022319999999999864,0.5517241379310345,16,13,29,58,42,16,9,16,20,2,0.1,"[0, 20, 40]",0.0003,0.001,0.0015,3
2813,0.03288999999999992,0.5945945945945946,24,17,33,74,57,17,9,16,20,2,0.1,"[0, 20, 40]",0.0003,0.001,0.0015,5
2814,0.008259999999999806,0.5652173913043478,3,7,13,23,15,8,9,16,20,2,0.1,"[0, 20, 40]",0.0003,0.0015,0.001,1
2815,0.020079999999999123,0.5689655172413793,6,18,34,58,42,16,9,16,20,2,0.1,"[0, 20, 40]",0.0003,0.0015,0.001,3
2816,0.02786999999999876,0.5866666666666667,9,24,42,75,58,17,9,16,20,2,0.1,"[0, 20, 40]",0.0003,0.0015,0.001,5
2817,0.010419999999999964,0.5217391304347826,4,5,14,23,15,8,9,16,20,2,0.1,"[0, 20, 40]",0.0003,0.0015,0.0015,1
2818,0.02350999999999922,0.5172413793103449,7,14,37,58,42,16,9,16,20,2,0.1,"[0, 20, 40]",0.0003,0.0015,0.0015,3
2819,0.03245999999999887,0.5405405405405406,11,18,45,74,57,17,9,16,20,2,0.1,"[0, 20, 40]",0.0003,0.0015,0.0015,5
2820,0.009199999999999691,0.5652173913043478,2,7,14,23,15,8,9,16,20,2,0.1,"[0, 20, 40]",0.0003,0.002,0.001,1
2821,0.021529999999998967,0.5689655172413793,4,18,36,58,42,16,9,16,20,2,0.1,"[0, 20, 40]",0.0003,0.002,0.001,3
2822,0.028049999999998448,0.5866666666666667,4,24,47,75,58,17,9,16,20,2,0.1,"[0, 20, 40]",0.0003,0.002,0.001,5
2823,0.01185999999999985,0.5217391304347826,3,5,15,23,15,8,9,16,20,2,0.1,"[0, 20, 40]",0.0003,0.002,0.0015,1
2824,0.025459999999999067,0.5172413793103449,5,14,39,58,42,16,9,16,20,2,0.1,"[0, 20, 40]",0.0003,0.002,0.0015,3
2825,0.03363999999999856,0.5405405405405406,6,18,50,74,57,17,9,16,20,2,0.1,"[0, 20, 40]",0.0003,0.002,0.0015,5
2826,0.005610000000000022,0.7777777777777778,5,2,2,9,6,3,9,16,20,2,0.1,"[0, 20, 40]",0.0005,0.001,0.001,1
2827,0.01783,0.8,11,11,8,30,24,6,9,16,20,2,0.1,"[0, 20, 40]",0.0005,0.001,0.001,3
2828,0.025579999999999756,0.7659574468085106,18,14,15,47,41,6,9,16,20,2,0.1,"[0, 20, 40]",0.0005,0.001,0.001,5
2829,0.004469999999999826,0.6666666666666666,5,1,3,9,6,3,9,16,20,2,0.1,"[0, 20, 40]",0.0005,0.001,0.0015,1
2830,0.01741999999999964,0.7,11,8,11,30,24,6,9,16,20,2,0.1,"[0, 20, 40]",0.0005,0.001,0.0015,3
2831,0.02440999999999931,0.6808510638297872,18,10,19,47,41,6,9,16,20,2,0.1,"[0, 20, 40]",0.0005,0.001,0.0015,5
2832,0.004550000000000129,0.5555555555555556,1,3,5,9,6,3,9,16,20,2,0.1,"[0, 20, 40]",0.0005,0.0015,0.001,1
2833,0.017739999999999857,0.7333333333333333,4,12,14,30,24,6,9,16,20,2,0.1,"[0, 20, 40]",0.0005,0.0015,0.001,3
2834,0.02732999999999951,0.723404255319149,9,15,23,47,41,6,9,16,20,2,0.1,"[0, 20, 40]",0.0005,0.0015,0.001,5
2835,0.0015899999999998901,0.3333333333333333,1,1,7,9,6,3,9,16,20,2,0.1,"[0, 20, 40]",0.0005,0.0015,0.0015,1
2836,0.015509999999999451,0.6,4,8,18,30,24,6,9,16,20,2,0.1,"[0, 20, 40]",0.0005,0.0015,0.0015,3
2837,0.024339999999999026,0.6170212765957447,9,10,28,47,41,6,9,16,20,2,0.1,"[0, 20, 40]",0.0005,0.0015,0.0015,5
2838,0.005050000000000129,0.5555555555555556,1,3,5,9,6,3,9,16,20,2,0.1,"[0, 20, 40]",0.0005,0.002,0.001,1
2839,0.019019999999999804,0.7333333333333333,3,12,15,30,24,6,9,16,20,2,0.1,"[0, 20, 40]",0.0005,0.002,0.001,3
2840,0.028269999999998845,0.723404255319149,5,15,27,47,41,6,9,16,20,2,0.1,"[0, 20, 40]",0.0005,0.002,0.001,5
2841,0.00208999999999989,0.3333333333333333,1,1,7,9,6,3,9,16,20,2,0.1,"[0, 20, 40]",0.0005,0.002,0.0015,1
2842,0.016789999999999403,0.6,3,8,19,30,24,6,9,16,20,2,0.1,"[0, 20, 40]",0.0005,0.002,0.0015,3
2843,0.02527999999999836,0.6170212765957447,5,10,32,47,41,6,9,16,20,2,0.1,"[0, 20, 40]",0.0005,0.002,0.0015,5
2844,0.0033299999999998296,0.6,4,2,4,10,9,1,9,16,20,2,0.2,"[0, 20, 40]",0.0003,0.001,0.001,1
2845,0.007640000000000331,0.5833333333333334,5,8,11,24,21,3,9,16,20,2,0.2,"[0, 20, 40]",0.0003,0.001,0.001,3
2846,0.013920000000000366,0.6285714285714286,9,12,14,35,31,4,9,16,20,2,0.2,"[0, 20, 40]",0.0003,0.001,0.001,5
2847,0.00432999999999983,0.6,4,2,4,10,9,1,9,16,20,2,0.2,"[0, 20, 40]",0.0003,0.001,0.0015,1
2848,0.0074100000000002645,0.5,5,6,13,24,21,3,9,16,20,2,0.2,"[0, 20, 40]",0.0003,0.001,0.0015,3
2849,0.015190000000000299,0.5714285714285714,10,9,16,35,31,4,9,16,20,2,0.2,"[0, 20, 40]",0.0003,0.001,0.0015,5
2850,0.003959999999999738,0.6,2,3,5,10,9,1,9,16,20,2,0.2,"[0, 20, 40]",0.0003,0.0015,0.001,1
2851,0.00761000000000019,0.5833333333333334,1,10,13,24,21,3,9,16,20,2,0.2,"[0, 20, 40]",0.0003,0.0015,0.001,3
2852,0.012680000000000127,0.6,2,15,18,35,31,4,9,16,20,2,0.2,"[0, 20, 40]",0.0003,0.0015,0.001,5
2853,0.005459999999999737,0.6,3,2,5,10,9,1,9,16,20,2,0.2,"[0, 20, 40]",0.0003,0.0015,0.0015,1
2854,0.008380000000000123,0.5,2,7,15,24,21,3,9,16,20,2,0.2,"[0, 20, 40]",0.0003,0.0015,0.0015,3
2855,0.013889999999999944,0.5142857142857142,4,10,21,35,31,4,9,16,20,2,0.2,"[0, 20, 40]",0.0003,0.0015,0.0015,5
2856,0.004399999999999624,0.6,1,3,6,10,9,1,9,16,20,2,0.2,"[0, 20, 40]",0.0003,0.002,0.001,1
2857,0.007550000000000077,0.5833333333333334,0,10,14,24,21,3,9,16,20,2,0.2,"[0, 20, 40]",0.0003,0.002,0.001,3
2858,0.012070000000000018,0.6,0,15,20,35,31,4,9,16,20,2,0.2,"[0, 20, 40]",0.0003,0.002,0.001,5
2859,0.006399999999999623,0.6,2,2,6,10,9,1,9,16,20,2,0.2,"[0, 20, 40]",0.0003,0.002,0.0015,1
2860,0.00882000000000001,0.5,1,7,16,24,21,3,9,16,20,2,0.2,"[0, 20, 40]",0.0003,0.002,0.0015,3
2861,0.014279999999999834,0.5142857142857142,2,10,23,35,31,4,9,16,20,2,0.2,"[0, 20, 40]",0.0003,0.002,0.0015,5
2862,0.0014899999999999237,0.6666666666666666,1,1,1,3,3,0,9,16,20,2,0.2,"[0, 20, 40]",0.0005,0.001,0.001,1
2863,0.006530000000000055,0.7142857142857143,2,6,6,14,13,1,9,16,20,2,0.2,"[0, 20, 40]",0.0005,0.001,0.001,3
2864,0.013229999999999957,0.76,7,9,9,25,24,1,9,16,20,2,0.2,"[0, 20, 40]",0.0005,0.001,0.001,5
2865,0.0019899999999999233,0.6666666666666666,1,1,1,3,3,0,9,16,20,2,0.2,"[0, 20, 40]",0.0005,0.001,0.0015,1
2866,0.005759999999999894,0.5714285714285714,2,4,8,14,13,1,9,16,20,2,0.2,"[0, 20, 40]",0.0005,0.001,0.0015,3
2867,0.011699999999999698,0.64,7,6,12,25,24,1,9,16,20,2,0.2,"[0, 20, 40]",0.0005,0.001,0.0015,5
2868,0.00131999999999981,0.6666666666666666,0,1,2,3,3,0,9,16,20,2,0.2,"[0, 20, 40]",0.0005,0.0015,0.001,1
2869,0.006859999999999941,0.7142857142857143,1,6,7,14,13,1,9,16,20,2,0.2,"[0, 20, 40]",0.0005,0.0015,0.001,3
2870,0.01439999999999974,0.76,4,9,12,25,24,1,9,16,20,2,0.2,"[0, 20, 40]",0.0005,0.0015,0.001,5
2871,0.0018199999999998098,0.6666666666666666,0,1,2,3,3,0,9,16,20,2,0.2,"[0, 20, 40]",0.0005,0.0015,0.0015,1
2872,0.00608999999999978,0.5714285714285714,1,4,9,14,13,1,9,16,20,2,0.2,"[0, 20, 40]",0.0005,0.0015,0.0015,3
2873,0.012869999999999479,0.64,4,6,15,25,24,1,9,16,20,2,0.2,"[0, 20, 40]",0.0005,0.0015,0.0015,5
2874,0.00131999999999981,0.6666666666666666,0,1,2,3,3,0,9,16,20,2,0.2,"[0, 20, 40]",0.0005,0.002,0.001,1
2875,0.007359999999999941,0.7142857142857143,1,6,7,14,13,1,9,16,20,2,0.2,"[0, 20, 40]",0.0005,0.002,0.001,3
2876,0.014779999999999344,0.76,2,9,14,25,24,1,9,16,20,2,0.2,"[0, 20, 40]",0.0005,0.002,0.001,5
2877,0.0018199999999998098,0.6666666666666666,0,1,2,3,3,0,9,16,20,2,0.2,"[0, 20, 40]",0.0005,0.002,0.0015,1
2878,0.00658999999999978,0.5714285714285714,1,4,9,14,13,1,9,16,20,2,0.2,"[0, 20, 40]",0.0005,0.002,0.0015,3
2879,0.013249999999999085,0.64,2,6,17,25,24,1,9,16,20,2,0.2,"[0, 20, 40]",0.0005,0.002,0.0015,5
2880,0.00733999999999846,0.4,5,8,27,40,25,15,9,17,5,1,0.1,"[0, 20, 40]",0.0003,0.001,0.001,1
2881,-0.0013100000000033885,0.27906976744186046,6,10,70,86,56,30,9,17,5,1,0.1,"[0, 20, 40]",0.0003,0.001,0.001,3
2882,-0.005020000000004532,0.23853211009174313,6,11,92,109,76,33,9,17,5,1,0.1,"[0, 20, 40]",0.0003,0.001,0.001,5
2883,0.003159999999998387,0.3,5,4,31,40,25,15,9,17,5,1,0.1,"[0, 20, 40]",0.0003,0.001,0.0015,1
2884,-0.009480000000003614,0.20930232558139536,6,4,76,86,56,30,9,17,5,1,0.1,"[0, 20, 40]",0.0003,0.001,0.0015,3
2885,-0.013190000000004786,0.1834862385321101,7,4,98,109,76,33,9,17,5,1,0.1,"[0, 20, 40]",0.0003,0.001,0.0015,5
2886,0.006049999999998228,0.375,0,9,31,40,25,15,9,17,5,1,0.1,"[0, 20, 40]",0.0003,0.0015,0.001,1
2887,-0.0025300000000037168,0.26744186046511625,0,11,75,86,56,30,9,17,5,1,0.1,"[0, 20, 40]",0.0003,0.0015,0.001,3
2888,-0.006240000000004861,0.22935779816513763,0,12,97,109,76,33,9,17,5,1,0.1,"[0, 20, 40]",0.0003,0.0015,0.001,5
2889,0.0003499999999982984,0.25,0,4,36,40,25,15,9,17,5,1,0.1,"[0, 20, 40]",0.0003,0.0015,0.0015,1
2890,-0.012220000000003802,0.18604651162790697,0,4,82,86,56,30,9,17,5,1,0.1,"[0, 20, 40]",0.0003,0.0015,0.0015,3
2891,-0.015830000000005093,0.1651376146788991,0,4,105,109,76,33,9,17,5,1,0.1,"[0, 20, 40]",0.0003,0.0015,0.0015,5
2892,0.006049999999998228,0.375,0,9,31,40,25,15,9,17,5,1,0.1,"[0, 20, 40]",0.0003,0.002,0.001,1
2893,-0.0025300000000037168,0.26744186046511625,0,11,75,86,56,30,9,17,5,1,0.1,"[0, 20, 40]",0.0003,0.002,0.001,3
2894,-0.006240000000004861,0.22935779816513763,0,12,97,109,76,33,9,17,5,1,0.1,"[0, 20, 40]",0.0003,0.002,0.001,5
2895,0.0003499999999982984,0.25,0,4,36,40,25,15,9,17,5,1,0.1,"[0, 20, 40]",0.0003,0.002,0.0015,1
2896,-0.012220000000003802,0.18604651162790697,0,4,82,86,56,30,9,17,5,1,0.1,"[0, 20, 40]",0.0003,0.002,0.0015,3
2897,-0.015830000000005093,0.1651376146788991,0,4,105,109,76,33,9,17,5,1,0.1,"[0, 20, 40]",0.0003,0.002,0.0015,5
2898,0.002369999999999427,0.6,1,2,7,10,6,4,9,17,5,1,0.1,"[0, 20, 40]",0.0005,0.001,0.001,1
2899,0.005009999999998093,0.46153846153846156,5,6,28,39,26,13,9,17,5,1,0.1,"[0, 20, 40]",0.0005,0.001,0.001,3
2900,0.002119999999996767,0.39344262295081966,6,6,49,61,47,14,9,17,5,1,0.1,"[0, 20, 40]",0.0005,0.001,0.001,5
2901,-0.0021700000000007824,0.4,1,0,9,10,6,4,9,17,5,1,0.1,"[0, 20, 40]",0.0005,0.001,0.0015,1
2902,-0.007400000000002379,0.3076923076923077,5,0,34,39,26,13,9,17,5,1,0.1,"[0, 20, 40]",0.0005,0.001,0.0015,3
2903,-0.010290000000003702,0.29508196721311475,6,0,55,61,47,14,9,17,5,1,0.1,"[0, 20, 40]",0.0005,0.001,0.0015,5
2904,0.0013999999999994017,0.5,0,2,8,10,6,4,9,17,5,1,0.1,"[0, 20, 40]",0.0005,0.0015,0.001,1
2905,0.003419999999997948,0.41025641025641024,1,6,32,39,26,13,9,17,5,1,0.1,"[0, 20, 40]",0.0005,0.0015,0.001,3
2906,0.0008299999999964784,0.36065573770491804,1,6,54,61,47,14,9,17,5,1,0.1,"[0, 20, 40]",0.0005,0.0015,0.001,5
2907,-0.003140000000000808,0.3,0,0,10,10,6,4,9,17,5,1,0.1,"[0, 20, 40]",0.0005,0.0015,0.0015,1
2908,-0.008990000000002524,0.2564102564102564,1,0,38,39,26,13,9,17,5,1,0.1,"[0, 20, 40]",0.0005,0.0015,0.0015,3
2909,-0.011580000000003993,0.26229508196721313,1,0,60,61,47,14,9,17,5,1,0.1,"[0, 20, 40]",0.0005,0.0015,0.0015,5
2910,0.0013999999999994017,0.5,0,2,8,10,6,4,9,17,5,1,0.1,"[0, 20, 40]",0.0005,0.002,0.001,1
2911,0.0036799999999979323,0.41025641025641024,0,6,33,39,26,13,9,17,5,1,0.1,"[0, 20, 40]",0.0005,0.002,0.001,3
2912,0.0010899999999964632,0.36065573770491804,0,6,55,61,47,14,9,17,5,1,0.1,"[0, 20, 40]",0.0005,0.002,0.001,5
2913,-0.003140000000000808,0.3,0,0,10,10,6,4,9,17,5,1,0.1,"[0, 20, 40]",0.0005,0.002,0.0015,1
2914,-0.00873000000000254,0.2564102564102564,0,0,39,39,26,13,9,17,5,1,0.1,"[0, 20, 40]",0.0005,0.002,0.0015,3
2915,-0.01132000000000401,0.26229508196721313,0,0,61,61,47,14,9,17,5,1,0.1,"[0, 20, 40]",0.0005,0.002,0.0015,5
2916,0.004719999999999413,0.42105263157894735,3,3,13,19,16,3,9,17,5,1,0.2,"[0, 20, 40]",0.0003,0.001,0.001,1
2917,-0.0014000000000012887,0.3,3,4,33,40,33,7,9,17,5,1,0.2,"[0, 20, 40]",0.0003,0.001,0.001,3
2918,-0.004430000000001396,0.23529411764705882,3,4,44,51,43,8,9,17,5,1,0.2,"[0, 20, 40]",0.0003,0.001,0.001,5
2919,0.003959999999999317,0.3684210526315789,3,2,14,19,16,3,9,17,5,1,0.2,"[0, 20, 40]",0.0003,0.001,0.0015,1
2920,-0.003940000000001384,0.25,3,2,35,40,33,7,9,17,5,1,0.2,"[0, 20, 40]",0.0003,0.001,0.0015,3
2921,-0.0069700000000014915,0.19607843137254902,3,2,46,51,43,8,9,17,5,1,0.2,"[0, 20, 40]",0.0003,0.001,0.0015,5
2922,0.003369999999999342,0.3684210526315789,0,3,16,19,16,3,9,17,5,1,0.2,"[0, 20, 40]",0.0003,0.0015,0.001,1
2923,-0.00275000000000136,0.275,0,4,36,40,33,7,9,17,5,1,0.2,"[0, 20, 40]",0.0003,0.0015,0.001,3
2924,-0.005780000000001467,0.21568627450980393,0,4,47,51,43,8,9,17,5,1,0.2,"[0, 20, 40]",0.0003,0.0015,0.001,5
2925,0.0026099999999992453,0.3157894736842105,0,2,17,19,16,3,9,17,5,1,0.2,"[0, 20, 40]",0.0003,0.0015,0.0015,1
2926,-0.005290000000001455,0.225,0,2,38,40,33,7,9,17,5,1,0.2,"[0, 20, 40]",0.0003,0.0015,0.0015,3
2927,-0.008320000000001562,0.17647058823529413,0,2,49,51,43,8,9,17,5,1,0.2,"[0, 20, 40]",0.0003,0.0015,0.0015,5
2928,0.003369999999999342,0.3684210526315789,0,3,16,19,16,3,9,17,5,1,0.2,"[0, 20, 40]",0.0003,0.002,0.001,1
2929,-0.00275000000000136,0.275,0,4,36,40,33,7,9,17,5,1,0.2,"[0, 20, 40]",0.0003,0.002,0.001,3
2930,-0.005780000000001467,0.21568627450980393,0,4,47,51,43,8,9,17,5,1,0.2,"[0, 20, 40]",0.0003,0.002,0.001,5
2931,0.0026099999999992453,0.3157894736842105,0,2,17,19,16,3,9,17,5,1,0.2,"[0, 20, 40]",0.0003,0.002,0.0015,1
2932,-0.005290000000001455,0.225,0,2,38,40,33,7,9,17,5,1,0.2,"[0, 20, 40]",0.0003,0.002,0.0015,3
2933,-0.008320000000001562,0.17647058823529413,0,2,49,51,43,8,9,17,5,1,0.2,"[0, 20, 40]",0.0003,0.002,0.0015,5
2934,0.0017999999999995797,0.8,0,1,4,5,4,1,9,17,5,1,0.2,"[0, 20, 40]",0.0005,0.001,0.001,1
2935,0.0008499999999987517,0.4090909090909091,2,3,17,22,19,3,9,17,5,1,0.2,"[0, 20, 40]",0.0005,0.001,0.001,3
2936,-0.0016700000000017916,0.30303030303030304,2,3,28,33,30,3,9,17,5,1,0.2,"[0, 20, 40]",0.0005,0.001,0.001,5
2937,-0.0004800000000005905,0.6,0,0,5,5,4,1,9,17,5,1,0.2,"[0, 20, 40]",0.0005,0.001,0.0015,1
2938,-0.0054900000000015865,0.2727272727272727,2,0,20,22,19,3,9,17,5,1,0.2,"[0, 20, 40]",0.0005,0.001,0.0015,3
2939,-0.008010000000002132,0.21212121212121213,2,0,31,33,30,3,9,17,5,1,0.2,"[0, 20, 40]",0.0005,0.001,0.0015,5
2940,0.0017999999999995797,0.8,0,1,4,5,4,1,9,17,5,1,0.2,"[0, 20, 40]",0.0005,0.0015,0.001,1
2941,0.0005699999999986381,0.36363636363636365,1,3,18,22,19,3,9,17,5,1,0.2,"[0, 20, 40]",0.0005,0.0015,0.001,3
2942,-0.0019500000000019046,0.2727272727272727,1,3,29,33,30,3,9,17,5,1,0.2,"[0, 20, 40]",0.0005,0.0015,0.001,5
2943,-0.0004800000000005905,0.6,0,0,5,5,4,1,9,17,5,1,0.2,"[0, 20, 40]",0.0005,0.0015,0.0015,1
2944,-0.005770000000001701,0.22727272727272727,1,0,21,22,19,3,9,17,5,1,0.2,"[0, 20, 40]",0.0005,0.0015,0.0015,3
2945,-0.008290000000002247,0.18181818181818182,1,0,32,33,30,3,9,17,5,1,0.2,"[0, 20, 40]",0.0005,0.0015,0.0015,5
2946,0.0017999999999995797,0.8,0,1,4,5,4,1,9,17,5,1,0.2,"[0, 20, 40]",0.0005,0.002,0.001,1
2947,0.0008299999999986219,0.36363636363636365,0,3,19,22,19,3,9,17,5,1,0.2,"[0, 20, 40]",0.0005,0.002,0.001,3
2948,-0.0016900000000019209,0.2727272727272727,0,3,30,33,30,3,9,17,5,1,0.2,"[0, 20, 40]",0.0005,0.002,0.001,5
2949,-0.0004800000000005905,0.6,0,0,5,5,4,1,9,17,5,1,0.2,"[0, 20, 40]",0.0005,0.002,0.0015,1
2950,-0.0055100000000017175,0.22727272727272727,0,0,22,22,19,3,9,17,5,1,0.2,"[0, 20, 40]",0.0005,0.002,0.0015,3
2951,-0.008030000000002263,0.18181818181818182,0,0,33,33,30,3,9,17,5,1,0.2,"[0, 20, 40]",0.0005,0.002,0.0015,5
2952,0.0029999999999989133,0.3448275862068966,3,4,22,29,20,9,9,17,5,2,0.1,"[0, 20, 40]",0.0003,0.001,0.001,1
2953,-0.005420000000002985,0.23943661971830985,4,7,60,71,53,18,9,17,5,2,0.1,"[0, 20, 40]",0.0003,0.001,0.001,3
2954,-0.00770000000000398,0.2159090909090909,4,8,76,88,69,19,9,17,5,2,0.1,"[0, 20, 40]",0.0003,0.001,0.001,5
2955,0.003439999999998963,0.3103448275862069,3,3,23,29,20,9,9,17,5,2,0.1,"[0, 20, 40]",0.0003,0.001,0.0015,1
2956,-0.008470000000003104,0.19718309859154928,4,4,63,71,53,18,9,17,5,2,0.1,"[0, 20, 40]",0.0003,0.001,0.0015,3
2957,-0.010750000000004093,0.18181818181818182,5,4,79,88,69,19,9,17,5,2,0.1,"[0, 20, 40]",0.0003,0.001,0.0015,5
2958,0.001209999999998847,0.3103448275862069,0,4,25,29,20,9,9,17,5,2,0.1,"[0, 20, 40]",0.0003,0.0015,0.001,1
2959,-0.007140000000003147,0.22535211267605634,0,7,64,71,53,18,9,17,5,2,0.1,"[0, 20, 40]",0.0003,0.0015,0.001,3
2960,-0.009420000000004147,0.20454545454545456,0,8,80,88,69,19,9,17,5,2,0.1,"[0, 20, 40]",0.0003,0.0015,0.001,5
2961,0.0016499999999988963,0.27586206896551724,0,3,26,29,20,9,9,17,5,2,0.1,"[0, 20, 40]",0.0003,0.0015,0.0015,1
2962,-0.01019000000000327,0.18309859154929578,0,4,67,71,53,18,9,17,5,2,0.1,"[0, 20, 40]",0.0003,0.0015,0.0015,3
2963,-0.01237000000000438,0.17045454545454544,0,4,84,88,69,19,9,17,5,2,0.1,"[0, 20, 40]",0.0003,0.0015,0.0015,5
2964,0.001209999999998847,0.3103448275862069,0,4,25,29,20,9,9,17,5,2,0.1,"[0, 20, 40]",0.0003,0.002,0.001,1
2965,-0.007140000000003147,0.22535211267605634,0,7,64,71,53,18,9,17,5,2,0.1,"[0, 20, 40]",0.0003,0.002,0.001,3
2966,-0.009420000000004147,0.20454545454545456,0,8,80,88,69,19,9,17,5,2,0.1,"[0, 20, 40]",0.0003,0.002,0.001,5
2967,0.0016499999999988963,0.27586206896551724,0,3,26,29,20,9,9,17,5,2,0.1,"[0, 20, 40]",0.0003,0.002,0.0015,1
2968,-0.01019000000000327,0.18309859154929578,0,4,67,71,53,18,9,17,5,2,0.1,"[0, 20, 40]",0.0003,0.002,0.0015,3
2969,-0.01237000000000438,0.17045454545454544,0,4,84,88,69,19,9,17,5,2,0.1,"[0, 20, 40]",0.0003,0.002,0.0015,5
2970,0.0024399999999996412,0.5454545454545454,1,2,8,11,8,3,9,17,5,2,0.1,"[0, 20, 40]",0.0005,0.001,0.001,1
2971,0.0037299999999987218,0.45454545454545453,3,6,24,33,27,6,9,17,5,2,0.1,"[0, 20, 40]",0.0005,0.001,0.001,3
2972,0.0021899999999981357,0.4,4,6,40,50,44,6,9,17,5,2,0.1,"[0, 20, 40]",0.0005,0.001,0.001,5
2973,-0.002100000000000568,0.36363636363636365,1,0,10,11,8,3,9,17,5,2,0.1,"[0, 20, 40]",0.0005,0.001,0.0015,1
2974,-0.008790000000001805,0.2727272727272727,3,0,30,33,27,6,9,17,5,2,0.1,"[0, 20, 40]",0.0005,0.001,0.0015,3
2975,-0.010330000000002388,0.28,4,0,46,50,44,6,9,17,5,2,0.1,"[0, 20, 40]",0.0005,0.001,0.0015,5
2976,0.001469999999999616,0.45454545454545453,0,2,9,11,8,3,9,17,5,2,0.1,"[0, 20, 40]",0.0005,0.0015,0.001,1
2977,0.0021199999999985007,0.3939393939393939,0,6,27,33,27,6,9,17,5,2,0.1,"[0, 20, 40]",0.0005,0.0015,0.001,3
2978,0.0008799999999977725,0.36,0,6,44,50,44,6,9,17,5,2,0.1,"[0, 20, 40]",0.0005,0.0015,0.001,5
2979,-0.0030700000000005935,0.2727272727272727,0,0,11,11,8,3,9,17,5,2,0.1,"[0, 20, 40]",0.0005,0.0015,0.0015,1
2980,-0.010400000000002027,0.21212121212121213,0,0,33,33,27,6,9,17,5,2,0.1,"[0, 20, 40]",0.0005,0.0015,0.0015,3
2981,-0.011640000000002756,0.24,0,0,50,50,44,6,9,17,5,2,0.1,"[0, 20, 40]",0.0005,0.0015,0.0015,5
2982,0.001469999999999616,0.45454545454545453,0,2,9,11,8,3,9,17,5,2,0.1,"[0, 20, 40]",0.0005,0.002,0.001,1
2983,0.0021199999999985007,0.3939393939393939,0,6,27,33,27,6,9,17,5,2,0.1,"[0, 20, 40]",0.0005,0.002,0.001,3
2984,0.0008799999999977725,0.36,0,6,44,50,44,6,9,17,5,2,0.1,"[0, 20, 40]",0.0005,0.002,0.001,5
2985,-0.0030700000000005935,0.2727272727272727,0,0,11,11,8,3,9,17,5,2,0.1,"[0, 20, 40]",0.0005,0.002,0.0015,1
2986,-0.010400000000002027,0.21212121212121213,0,0,33,33,27,6,9,17,5,2,0.1,"[0, 20, 40]",0.0005,0.002,0.0015,3
2987,-0.011640000000002756,0.24,0,0,50,50,44,6,9,17,5,2,0.1,"[0, 20, 40]",0.0005,0.002,0.0015,5
2988,0.0034799999999995035,0.5,3,2,9,14,13,1,9,17,5,2,0.2,"[0, 20, 40]",0.0003,0.001,0.001,1
2989,-0.0004900000000013905,0.3333333333333333,3,4,26,33,29,4,9,17,5,2,0.2,"[0, 20, 40]",0.0003,0.001,0.001,3
2990,-0.0019700000000016722,0.2727272727272727,3,5,36,44,39,5,9,17,5,2,0.2,"[0, 20, 40]",0.0003,0.001,0.001,5
2991,0.004479999999999503,0.5,3,2,9,14,13,1,9,17,5,2,0.2,"[0, 20, 40]",0.0003,0.001,0.0015,1
2992,-0.0007700000000013936,0.30303030303030304,3,3,27,33,29,4,9,17,5,2,0.2,"[0, 20, 40]",0.0003,0.001,0.0015,3
2993,-0.0022500000000016756,0.25,4,3,37,44,39,5,9,17,5,2,0.2,"[0, 20, 40]",0.0003,0.001,0.0015,5
2994,0.0016899999999994367,0.42857142857142855,0,2,12,14,13,1,9,17,5,2,0.2,"[0, 20, 40]",0.0003,0.0015,0.001,1
2995,-0.0022800000000014575,0.30303030303030304,0,4,29,33,29,4,9,17,5,2,0.2,"[0, 20, 40]",0.0003,0.0015,0.001,3
2996,-0.003760000000001738,0.25,0,5,39,44,39,5,9,17,5,2,0.2,"[0, 20, 40]",0.0003,0.0015,0.001,5
2997,0.002689999999999436,0.42857142857142855,0,2,12,14,13,1,9,17,5,2,0.2,"[0, 20, 40]",0.0003,0.0015,0.0015,1
2998,-0.0025600000000014604,0.2727272727272727,0,3,30,33,29,4,9,17,5,2,0.2,"[0, 20, 40]",0.0003,0.0015,0.0015,3
2999,-0.003940000000001863,0.22727272727272727,0,3,41,44,39,5,9,17,5,2,0.2,"[0, 20, 40]",0.0003,0.0015,0.0015,5
3000,0.0016899999999994367,0.42857142857142855,0,2,12,14,13,1,9,17,5,2,0.2,"[0, 20, 40]",0.0003,0.002,0.001,1
3001,-0.0022800000000014575,0.30303030303030304,0,4,29,33,29,4,9,17,5,2,0.2,"[0, 20, 40]",0.0003,0.002,0.001,3
3002,-0.003760000000001738,0.25,0,5,39,44,39,5,9,17,5,2,0.2,"[0, 20, 40]",0.0003,0.002,0.001,5
3003,0.002689999999999436,0.42857142857142855,0,2,12,14,13,1,9,17,5,2,0.2,"[0, 20, 40]",0.0003,0.002,0.0015,1
3004,-0.0025600000000014604,0.2727272727272727,0,3,30,33,29,4,9,17,5,2,0.2,"[0, 20, 40]",0.0003,0.002,0.0015,3
3005,-0.003940000000001863,0.22727272727272727,0,3,41,44,39,5,9,17,5,2,0.2,"[0, 20, 40]",0.0003,0.002,0.0015,5
3006,0.0005699999999997595,0.5,0,1,3,4,4,0,9,17,5,2,0.2,"[0, 20, 40]",0.0005,0.001,0.001,1
3007,0.0021799999999992468,0.47058823529411764,2,4,11,17,16,1,9,17,5,2,0.2,"[0, 20, 40]",0.0005,0.001,0.001,3
3008,0.0019099999999988996,0.39285714285714285,3,4,21,28,27,1,9,17,5,2,0.2,"[0, 20, 40]",0.0005,0.001,0.001,5
3009,-0.0017100000000004108,0.25,0,0,4,4,4,0,9,17,5,2,0.2,"[0, 20, 40]",0.0005,0.001,0.0015,1
3010,-0.00607000000000106,0.23529411764705882,2,0,15,17,16,1,9,17,5,2,0.2,"[0, 20, 40]",0.0005,0.001,0.0015,3
3011,-0.006340000000001406,0.25,3,0,25,28,27,1,9,17,5,2,0.2,"[0, 20, 40]",0.0005,0.001,0.0015,5
3012,0.0005699999999997595,0.5,0,1,3,4,4,0,9,17,5,2,0.2,"[0, 20, 40]",0.0005,0.0015,0.001,1
3013,0.0015399999999990521,0.4117647058823529,0,4,13,17,16,1,9,17,5,2,0.2,"[0, 20, 40]",0.0005,0.0015,0.001,3
3014,0.0015699999999985621,0.35714285714285715,0,4,24,28,27,1,9,17,5,2,0.2,"[0, 20, 40]",0.0005,0.0015,0.001,5
3015,-0.0017100000000004108,0.25,0,0,4,4,4,0,9,17,5,2,0.2,"[0, 20, 40]",0.0005,0.0015,0.0015,1
3016,-0.006710000000001255,0.17647058823529413,0,0,17,17,16,1,9,17,5,2,0.2,"[0, 20, 40]",0.0005,0.0015,0.0015,3
3017,-0.006680000000001744,0.21428571428571427,0,0,28,28,27,1,9,17,5,2,0.2,"[0, 20, 40]",0.0005,0.0015,0.0015,5
3018,0.0005699999999997595,0.5,0,1,3,4,4,0,9,17,5,2,0.2,"[0, 20, 40]",0.0005,0.002,0.001,1
3019,0.0015399999999990521,0.4117647058823529,0,4,13,17,16,1,9,17,5,2,0.2,"[0, 20, 40]",0.0005,0.002,0.001,3
3020,0.0015699999999985621,0.35714285714285715,0,4,24,28,27,1,9,17,5,2,0.2,"[0, 20, 40]",0.0005,0.002,0.001,5
3021,-0.0017100000000004108,0.25,0,0,4,4,4,0,9,17,5,2,0.2,"[0, 20, 40]",0.0005,0.002,0.0015,1
3022,-0.006710000000001255,0.17647058823529413,0,0,17,17,16,1,9,17,5,2,0.2,"[0, 20, 40]",0.0005,0.002,0.0015,3
3023,-0.006680000000001744,0.21428571428571427,0,0,28,28,27,1,9,17,5,2,0.2,"[0, 20, 40]",0.0005,0.002,0.0015,5
3024,0.009949999999998566,0.55,8,8,24,40,25,15,9,17,10,1,0.1,"[0, 20, 40]",0.0003,0.001,0.001,1
3025,0.006679999999998081,0.42528735632183906,16,14,57,87,57,30,9,17,10,1,0.1,"[0, 20, 40]",0.0003,0.001,0.001,3
3026,0.012889999999997256,0.45045045045045046,19,18,74,111,78,33,9,17,10,1,0.1,"[0, 20, 40]",0.0003,0.001,0.001,5
3027,0.007079999999998642,0.45,8,4,28,40,25,15,9,17,10,1,0.1,"[0, 20, 40]",0.0003,0.001,0.0015,1
3028,0.0023999999999980153,0.3563218390804598,16,8,63,87,57,30,9,17,10,1,0.1,"[0, 20, 40]",0.0003,0.001,0.0015,3
3029,0.005709999999997135,0.3783783783783784,20,9,82,111,78,33,9,17,10,1,0.1,"[0, 20, 40]",0.0003,0.001,0.0015,5
3030,0.01154999999999861,0.55,4,10,26,40,25,15,9,17,10,1,0.1,"[0, 20, 40]",0.0003,0.0015,0.001,1
3031,0.007419999999997827,0.42528735632183906,4,16,67,87,57,30,9,17,10,1,0.1,"[0, 20, 40]",0.0003,0.0015,0.001,3
3032,0.012189999999996563,0.44144144144144143,4,20,87,111,78,33,9,17,10,1,0.1,"[0, 20, 40]",0.0003,0.0015,0.001,5
3033,0.008499999999998554,0.425,5,4,31,40,25,15,9,17,10,1,0.1,"[0, 20, 40]",0.0003,0.0015,0.0015,1
3034,0.002959999999997641,0.3448275862068966,5,8,74,87,57,30,9,17,10,1,0.1,"[0, 20, 40]",0.0003,0.0015,0.0015,3
3035,0.005089999999996137,0.36036036036036034,5,9,97,111,78,33,9,17,10,1,0.1,"[0, 20, 40]",0.0003,0.0015,0.0015,5
3036,0.011219999999998448,0.55,2,10,28,40,25,15,9,17,10,1,0.1,"[0, 20, 40]",0.0003,0.002,0.001,1
3037,0.007089999999997665,0.42528735632183906,2,16,69,87,57,30,9,17,10,1,0.1,"[0, 20, 40]",0.0003,0.002,0.001,3
3038,0.011859999999996401,0.44144144144144143,2,20,89,111,78,33,9,17,10,1,0.1,"[0, 20, 40]",0.0003,0.002,0.001,5
3039,0.008499999999998394,0.425,2,4,34,40,25,15,9,17,10,1,0.1,"[0, 20, 40]",0.0003,0.002,0.0015,1
3040,0.0029599999999974764,0.3448275862068966,2,8,77,87,57,30,9,17,10,1,0.1,"[0, 20, 40]",0.0003,0.002,0.0015,3
3041,0.005089999999995974,0.36036036036036034,2,9,100,111,78,33,9,17,10,1,0.1,"[0, 20, 40]",0.0003,0.002,0.0015,5
3042,0.006039999999999931,0.8,4,3,3,10,6,4,9,17,10,1,0.1,"[0, 20, 40]",0.0005,0.001,0.001,1
3043,0.012519999999999634,0.575,11,9,20,40,27,13,9,17,10,1,0.1,"[0, 20, 40]",0.0005,0.001,0.001,3
3044,0.0177299999999984,0.5555555555555556,17,11,35,63,49,14,9,17,10,1,0.1,"[0, 20, 40]",0.0005,0.001,0.001,5
3045,0.0033599999999999706,0.6,4,1,5,10,6,4,9,17,10,1,0.1,"[0, 20, 40]",0.0005,0.001,0.0015,1
3046,0.008629999999999517,0.475,11,5,24,40,27,13,9,17,10,1,0.1,"[0, 20, 40]",0.0005,0.001,0.0015,3
3047,0.012899999999998057,0.47619047619047616,17,6,40,63,49,14,9,17,10,1,0.1,"[0, 20, 40]",0.0005,0.001,0.0015,5
3048,0.004449999999999452,0.6,1,3,6,10,6,4,9,17,10,1,0.1,"[0, 20, 40]",0.0005,0.0015,0.001,1
3049,0.013129999999999023,0.525,5,9,26,40,27,13,9,17,10,1,0.1,"[0, 20, 40]",0.0005,0.0015,0.001,3
3050,0.019849999999996912,0.5238095238095238,7,11,45,63,49,14,9,17,10,1,0.1,"[0, 20, 40]",0.0005,0.0015,0.001,5
3051,0.0017699999999994933,0.4,1,1,8,10,6,4,9,17,10,1,0.1,"[0, 20, 40]",0.0005,0.0015,0.0015,1
3052,0.009239999999998907,0.425,5,5,30,40,27,13,9,17,10,1,0.1,"[0, 20, 40]",0.0005,0.0015,0.0015,3
3053,0.015019999999996573,0.4444444444444444,7,6,50,63,49,14,9,17,10,1,0.1,"[0, 20, 40]",0.0005,0.0015,0.0015,5
3054,0.004949999999999451,0.6,1,3,6,10,6,4,9,17,10,1,0.1,"[0, 20, 40]",0.0005,0.002,0.001,1
3055,0.012629999999998691,0.5,3,9,28,40,27,13,9,17,10,1,0.1,"[0, 20, 40]",0.0005,0.002,0.001,3
3056,0.01938999999999651,0.5079365079365079,4,11,48,63,49,14,9,17,10,1,0.1,"[0, 20, 40]",0.0005,0.002,0.001,5
3057,0.0022699999999994933,0.4,1,1,8,10,6,4,9,17,10,1,0.1,"[0, 20, 40]",0.0005,0.002,0.0015,1
3058,0.008739999999998575,0.4,3,5,32,40,27,13,9,17,10,1,0.1,"[0, 20, 40]",0.0005,0.002,0.0015,3
3059,0.01455999999999616,0.42857142857142855,4,6,53,63,49,14,9,17,10,1,0.1,"[0, 20, 40]",0.0005,0.002,0.0015,5
3060,0.005639999999999777,0.5789473684210527,6,3,10,19,16,3,9,17,10,1,0.2,"[0, 20, 40]",0.0003,0.001,0.001,1
3061,0.002229999999999726,0.4,8,6,26,40,33,7,9,17,10,1,0.2,"[0, 20, 40]",0.0003,0.001,0.001,3
3062,0.007759999999999389,0.46153846153846156,10,9,33,52,44,8,9,17,10,1,0.2,"[0, 20, 40]",0.0003,0.001,0.001,5
3063,0.0057099999999997925,0.5263157894736842,6,2,11,19,16,3,9,17,10,1,0.2,"[0, 20, 40]",0.0003,0.001,0.0015,1
3064,0.0011399999999996912,0.35,8,4,28,40,33,7,9,17,10,1,0.2,"[0, 20, 40]",0.0003,0.001,0.0015,3
3065,0.003769999999999277,0.38461538461538464,10,5,37,52,44,8,9,17,10,1,0.2,"[0, 20, 40]",0.0003,0.001,0.0015,5
3066,0.006739999999999822,0.5789473684210527,3,4,12,19,16,3,9,17,10,1,0.2,"[0, 20, 40]",0.0003,0.0015,0.001,1
3067,0.0028099999999996973,0.4,3,7,30,40,33,7,9,17,10,1,0.2,"[0, 20, 40]",0.0003,0.0015,0.001,3
3068,0.00685999999999899,0.4423076923076923,3,10,39,52,44,8,9,17,10,1,0.2,"[0, 20, 40]",0.0003,0.0015,0.001,5
3069,0.006129999999999714,0.47368421052631576,3,2,14,19,16,3,9,17,10,1,0.2,"[0, 20, 40]",0.0003,0.0015,0.0015,1
3070,0.001039999999999538,0.325,3,4,33,40,33,7,9,17,10,1,0.2,"[0, 20, 40]",0.0003,0.0015,0.0015,3
3071,0.002189999999998756,0.34615384615384615,3,5,44,52,44,8,9,17,10,1,0.2,"[0, 20, 40]",0.0003,0.0015,0.0015,5
3072,0.00590999999999966,0.5789473684210527,1,4,14,19,16,3,9,17,10,1,0.2,"[0, 20, 40]",0.0003,0.002,0.001,1
3073,0.0019799999999995373,0.4,1,7,32,40,33,7,9,17,10,1,0.2,"[0, 20, 40]",0.0003,0.002,0.001,3
3074,0.006029999999998826,0.4423076923076923,1,10,41,52,44,8,9,17,10,1,0.2,"[0, 20, 40]",0.0003,0.002,0.001,5
3075,0.005299999999999552,0.47368421052631576,1,2,16,19,16,3,9,17,10,1,0.2,"[0, 20, 40]",0.0003,0.002,0.0015,1
3076,0.00020999999999937613,0.325,1,4,35,40,33,7,9,17,10,1,0.2,"[0, 20, 40]",0.0003,0.002,0.0015,3
3077,0.001359999999998595,0.34615384615384615,1,5,46,52,44,8,9,17,10,1,0.2,"[0, 20, 40]",0.0003,0.002,0.0015,5
3078,0.002759999999999872,0.8,2,1,2,5,4,1,9,17,10,1,0.2,"[0, 20, 40]",0.0005,0.001,0.001,1
3079,0.004979999999999826,0.5454545454545454,5,4,13,22,19,3,9,17,10,1,0.2,"[0, 20, 40]",0.0005,0.001,0.001,3
3080,0.007199999999999117,0.5294117647058824,6,6,22,34,31,3,9,17,10,1,0.2,"[0, 20, 40]",0.0005,0.001,0.001,5
3081,0.0032599999999998715,0.8,2,1,2,5,4,1,9,17,10,1,0.2,"[0, 20, 40]",0.0005,0.001,0.0015,1
3082,0.004479999999999713,0.5,5,3,14,22,19,3,9,17,10,1,0.2,"[0, 20, 40]",0.0005,0.001,0.0015,3
3083,0.005759999999998784,0.47058823529411764,6,4,24,34,31,3,9,17,10,1,0.2,"[0, 20, 40]",0.0005,0.001,0.0015,5
3084,0.002639999999999697,0.6,1,1,3,5,4,1,9,17,10,1,0.2,"[0, 20, 40]",0.0005,0.0015,0.001,1
3085,0.0053199999999996115,0.5,2,4,16,22,19,3,9,17,10,1,0.2,"[0, 20, 40]",0.0005,0.0015,0.001,3
3086,0.007419999999998673,0.5,2,6,26,34,31,3,9,17,10,1,0.2,"[0, 20, 40]",0.0005,0.0015,0.001,5
3087,0.0031399999999996964,0.6,1,1,3,5,4,1,9,17,10,1,0.2,"[0, 20, 40]",0.0005,0.0015,0.0015,1
3088,0.004819999999999501,0.45454545454545453,2,3,17,22,19,3,9,17,10,1,0.2,"[0, 20, 40]",0.0005,0.0015,0.0015,3
3089,0.005979999999998342,0.4411764705882353,2,4,28,34,31,3,9,17,10,1,0.2,"[0, 20, 40]",0.0005,0.0015,0.0015,5
3090,0.003139999999999697,0.6,1,1,3,5,4,1,9,17,10,1,0.2,"[0, 20, 40]",0.0005,0.002,0.001,1
3091,0.004639999999999487,0.45454545454545453,1,4,17,22,19,3,9,17,10,1,0.2,"[0, 20, 40]",0.0005,0.002,0.001,3
3092,0.006739999999998548,0.47058823529411764,1,6,27,34,31,3,9,17,10,1,0.2,"[0, 20, 40]",0.0005,0.002,0.001,5
3093,0.0036399999999996964,0.6,1,1,3,5,4,1,9,17,10,1,0.2,"[0, 20, 40]",0.0005,0.002,0.0015,1
3094,0.004139999999999374,0.4090909090909091,1,3,18,22,19,3,9,17,10,1,0.2,"[0, 20, 40]",0.0005,0.002,0.0015,3
3095,0.005299999999998215,0.4117647058823529,1,4,29,34,31,3,9,17,10,1,0.2,"[0, 20, 40]",0.0005,0.002,0.0015,5
3096,0.003879999999998793,0.4482758620689655,4,4,21,29,20,9,9,17,10,2,0.1,"[0, 20, 40]",0.0003,0.001,0.001,1
3097,0.0031499999999979357,0.3888888888888889,11,11,50,72,54,18,9,17,10,2,0.1,"[0, 20, 40]",0.0003,0.001,0.001,3
3098,0.009209999999997382,0.43333333333333335,14,15,61,90,71,19,9,17,10,2,0.1,"[0, 20, 40]",0.0003,0.001,0.001,5
3099,0.004459999999998874,0.41379310344827586,4,3,22,29,20,9,9,17,10,2,0.1,"[0, 20, 40]",0.0003,0.001,0.0015,1
3100,0.004569999999997965,0.3611111111111111,11,9,52,72,54,18,9,17,10,2,0.1,"[0, 20, 40]",0.0003,0.001,0.0015,3
3101,0.007729999999997342,0.3888888888888889,15,10,65,90,71,19,9,17,10,2,0.1,"[0, 20, 40]",0.0003,0.001,0.0015,5
3102,0.004329999999998855,0.4482758620689655,2,5,22,29,20,9,9,17,10,2,0.1,"[0, 20, 40]",0.0003,0.0015,0.001,1
3103,0.0031099999999977894,0.3888888888888889,2,12,58,72,54,18,9,17,10,2,0.1,"[0, 20, 40]",0.0003,0.0015,0.001,3
3104,0.007729999999996798,0.4222222222222222,2,16,72,90,71,19,9,17,10,2,0.1,"[0, 20, 40]",0.0003,0.0015,0.001,5
3105,0.00422999999999881,0.3793103448275862,2,3,24,29,20,9,9,17,10,2,0.1,"[0, 20, 40]",0.0003,0.0015,0.0015,1
3106,0.0038499999999976947,0.3472222222222222,2,9,61,72,54,18,9,17,10,2,0.1,"[0, 20, 40]",0.0003,0.0015,0.0015,3
3107,0.005829999999996449,0.36666666666666664,2,10,78,90,71,19,9,17,10,2,0.1,"[0, 20, 40]",0.0003,0.0015,0.0015,5
3108,0.004769999999998963,0.4482758620689655,1,5,23,29,20,9,9,17,10,2,0.1,"[0, 20, 40]",0.0003,0.002,0.001,1
3109,0.0035499999999978973,0.3888888888888889,1,12,59,72,54,18,9,17,10,2,0.1,"[0, 20, 40]",0.0003,0.002,0.001,3
3110,0.008169999999996905,0.4222222222222222,1,16,73,90,71,19,9,17,10,2,0.1,"[0, 20, 40]",0.0003,0.002,0.001,5
3111,0.004669999999998918,0.3793103448275862,1,3,25,29,20,9,9,17,10,2,0.1,"[0, 20, 40]",0.0003,0.002,0.0015,1
3112,0.004289999999997804,0.3472222222222222,1,9,62,72,54,18,9,17,10,2,0.1,"[0, 20, 40]",0.0003,0.002,0.0015,3
3113,0.006269999999996557,0.36666666666666664,1,10,79,90,71,19,9,17,10,2,0.1,"[0, 20, 40]",0.0003,0.002,0.0015,5
3114,0.00441,0.6363636363636364,4,2,5,11,8,3,9,17,10,2,0.1,"[0, 20, 40]",0.0005,0.001,0.001,1
3115,0.011759999999999673,0.5882352941176471,9,9,16,34,28,6,9,17,10,2,0.1,"[0, 20, 40]",0.0005,0.001,0.001,3
3116,0.016789999999998813,0.5769230769230769,14,11,27,52,46,6,9,17,10,2,0.1,"[0, 20, 40]",0.0005,0.001,0.001,5
3117,0.00260999999999992,0.5454545454545454,4,1,6,11,8,3,9,17,10,2,0.1,"[0, 20, 40]",0.0005,0.001,0.0015,1
3118,0.00907999999999943,0.5,9,6,19,34,28,6,9,17,10,2,0.1,"[0, 20, 40]",0.0005,0.001,0.0015,3
3119,0.013169999999998351,0.5,14,7,31,52,46,6,9,17,10,2,0.1,"[0, 20, 40]",0.0005,0.001,0.0015,5
3120,0.0028199999999995212,0.45454545454545453,1,2,8,11,8,3,9,17,10,2,0.1,"[0, 20, 40]",0.0005,0.0015,0.001,1
3121,0.011369999999999063,0.5294117647058824,3,9,22,34,28,6,9,17,10,2,0.1,"[0, 20, 40]",0.0005,0.0015,0.001,3
3122,0.01798999999999752,0.5384615384615384,5,11,36,52,46,6,9,17,10,2,0.1,"[0, 20, 40]",0.0005,0.0015,0.001,5
3123,0.0010199999999994428,0.36363636363636365,1,1,9,11,8,3,9,17,10,2,0.1,"[0, 20, 40]",0.0005,0.0015,0.0015,1
3124,0.008689999999998825,0.4411764705882353,3,6,25,34,28,6,9,17,10,2,0.1,"[0, 20, 40]",0.0005,0.0015,0.0015,3
3125,0.014369999999997054,0.46153846153846156,5,7,40,52,46,6,9,17,10,2,0.1,"[0, 20, 40]",0.0005,0.0015,0.0015,5
3126,0.0033199999999995213,0.45454545454545453,1,2,8,11,8,3,9,17,10,2,0.1,"[0, 20, 40]",0.0005,0.002,0.001,1
3127,0.011549999999998853,0.5294117647058824,2,9,23,34,28,6,9,17,10,2,0.1,"[0, 20, 40]",0.0005,0.002,0.001,3
3128,0.018209999999997246,0.5384615384615384,3,11,38,52,46,6,9,17,10,2,0.1,"[0, 20, 40]",0.0005,0.002,0.001,5
3129,0.0015199999999994428,0.36363636363636365,1,1,9,11,8,3,9,17,10,2,0.1,"[0, 20, 40]",0.0005,0.002,0.0015,1
3130,0.008869999999998615,0.4411764705882353,2,6,26,34,28,6,9,17,10,2,0.1,"[0, 20, 40]",0.0005,0.002,0.0015,3
3131,0.014589999999996772,0.46153846153846156,3,7,42,52,46,6,9,17,10,2,0.1,"[0, 20, 40]",0.0005,0.002,0.0015,5
3132,0.0028599999999998826,0.5714285714285714,3,2,9,14,13,1,9,17,10,2,0.2,"[0, 20, 40]",0.0003,0.001,0.001,1
3133,0.0018299999999998174,0.42424242424242425,5,6,22,33,29,4,9,17,10,2,0.2,"[0, 20, 40]",0.0003,0.001,0.001,3
3134,0.007599999999999271,0.5111111111111111,6,10,29,45,40,5,9,17,10,2,0.2,"[0, 20, 40]",0.0003,0.001,0.001,5
3135,0.0038599999999998818,0.5714285714285714,3,2,9,14,13,1,9,17,10,2,0.2,"[0, 20, 40]",0.0003,0.001,0.0015,1
3136,0.0021699999999997654,0.3939393939393939,5,5,23,33,29,4,9,17,10,2,0.2,"[0, 20, 40]",0.0003,0.001,0.0015,3
3137,0.005039999999999149,0.4444444444444444,7,6,32,45,40,5,9,17,10,2,0.2,"[0, 20, 40]",0.0003,0.001,0.0015,5
3138,0.002809999999999944,0.5714285714285714,1,3,10,14,13,1,9,17,10,2,0.2,"[0, 20, 40]",0.0003,0.0015,0.001,1
3139,0.0019099999999998437,0.42424242424242425,1,7,25,33,29,4,9,17,10,2,0.2,"[0, 20, 40]",0.0003,0.0015,0.001,3
3140,0.006419999999999149,0.4888888888888889,1,11,33,45,40,5,9,17,10,2,0.2,"[0, 20, 40]",0.0003,0.0015,0.001,5
3141,0.003129999999999819,0.5,1,2,11,14,13,1,9,17,10,2,0.2,"[0, 20, 40]",0.0003,0.0015,0.0015,1
3142,0.001569999999999668,0.36363636363636365,1,5,27,33,29,4,9,17,10,2,0.2,"[0, 20, 40]",0.0003,0.0015,0.0015,3
3143,0.0034399999999987175,0.4,1,6,38,45,40,5,9,17,10,2,0.2,"[0, 20, 40]",0.0003,0.0015,0.0015,5
3144,0.002750000000000052,0.5714285714285714,0,3,11,14,13,1,9,17,10,2,0.2,"[0, 20, 40]",0.0003,0.002,0.001,1
3145,0.0018499999999999515,0.42424242424242425,0,7,26,33,29,4,9,17,10,2,0.2,"[0, 20, 40]",0.0003,0.002,0.001,3
3146,0.006359999999999256,0.4888888888888889,0,11,34,45,40,5,9,17,10,2,0.2,"[0, 20, 40]",0.0003,0.002,0.001,5
3147,0.003069999999999927,0.5,0,2,12,14,13,1,9,17,10,2,0.2,"[0, 20, 40]",0.0003,0.002,0.0015,1
3148,0.0015099999999997758,0.36363636363636365,0,5,28,33,29,4,9,17,10,2,0.2,"[0, 20, 40]",0.0003,0.002,0.0015,3
3149,0.003379999999998826,0.4,0,6,39,45,40,5,9,17,10,2,0.2,"[0, 20, 40]",0.0003,0.002,0.0015,5
3150,0.0006499999999998396,0.5,0,1,3,4,4,0,9,17,10,2,0.2,"[0, 20, 40]",0.0005,0.001,0.001,1
3151,0.002859999999999815,0.47058823529411764,2,5,10,17,16,1,9,17,10,2,0.2,"[0, 20, 40]",0.0005,0.001,0.001,3
3152,0.006359999999999274,0.5172413793103449,5,7,17,29,28,1,9,17,10,2,0.2,"[0, 20, 40]",0.0005,0.001,0.001,5
3153,0.001149999999999839,0.5,0,1,3,4,4,0,9,17,10,2,0.2,"[0, 20, 40]",0.0005,0.001,0.0015,1
3154,0.0009799999999996556,0.35294117647058826,2,3,12,17,16,1,9,17,10,2,0.2,"[0, 20, 40]",0.0005,0.001,0.0015,3
3155,0.0035399999999988934,0.41379310344827586,5,4,20,29,28,1,9,17,10,2,0.2,"[0, 20, 40]",0.0005,0.001,0.0015,5
3156,0.0006499999999998396,0.5,0,1,3,4,4,0,9,17,10,2,0.2,"[0, 20, 40]",0.0005,0.0015,0.001,1
3157,0.003319999999999664,0.47058823529411764,1,5,11,17,16,1,9,17,10,2,0.2,"[0, 20, 40]",0.0005,0.0015,0.001,3
3158,0.0074099999999984395,0.5172413793103449,1,7,21,29,28,1,9,17,10,2,0.2,"[0, 20, 40]",0.0005,0.0015,0.001,5
3159,0.001149999999999839,0.5,0,1,3,4,4,0,9,17,10,2,0.2,"[0, 20, 40]",0.0005,0.0015,0.0015,1
3160,0.0014399999999995053,0.35294117647058826,1,3,13,17,16,1,9,17,10,2,0.2,"[0, 20, 40]",0.0005,0.0015,0.0015,3
3161,0.00458999999999806,0.41379310344827586,1,4,24,29,28,1,9,17,10,2,0.2,"[0, 20, 40]",0.0005,0.0015,0.0015,5
3162,0.0006499999999998396,0.5,0,1,3,4,4,0,9,17,10,2,0.2,"[0, 20, 40]",0.0005,0.002,0.001,1
3163,0.0038199999999996644,0.47058823529411764,1,5,11,17,16,1,9,17,10,2,0.2,"[0, 20, 40]",0.0005,0.002,0.001,3
3164,0.007909999999998437,0.5172413793103449,1,7,21,29,28,1,9,17,10,2,0.2,"[0, 20, 40]",0.0005,0.002,0.001,5
3165,0.001149999999999839,0.5,0,1,3,4,4,0,9,17,10,2,0.2,"[0, 20, 40]",0.0005,0.002,0.0015,1
3166,0.0019399999999995046,0.35294117647058826,1,3,13,17,16,1,9,17,10,2,0.2,"[0, 20, 40]",0.0005,0.002,0.0015,3
3167,0.005089999999998061,0.41379310344827586,1,4,24,29,28,1,9,17,10,2,0.2,"[0, 20, 40]",0.0005,0.002,0.0015,5
3168,0.011039999999998756,0.6052631578947368,9,10,19,38,23,15,9,17,15,1,0.1,"[0, 20, 40]",0.0003,0.001,0.001,1
3169,0.020199999999997106,0.5476190476190477,18,21,45,84,54,30,9,17,15,1,0.1,"[0, 20, 40]",0.0003,0.001,0.001,3
3170,0.027279999999996453,0.5514018691588785,23,25,59,107,74,33,9,17,15,1,0.1,"[0, 20, 40]",0.0003,0.001,0.001,5
3171,0.003569999999998612,0.47368421052631576,10,3,25,38,23,15,9,17,15,1,0.1,"[0, 20, 40]",0.0003,0.001,0.0015,1
3172,0.009809999999996662,0.44047619047619047,19,10,55,84,54,30,9,17,15,1,0.1,"[0, 20, 40]",0.0003,0.001,0.0015,3
3173,0.015729999999996174,0.45794392523364486,25,12,70,107,74,33,9,17,15,1,0.1,"[0, 20, 40]",0.0003,0.001,0.0015,5
3174,0.013569999999998507,0.6052631578947368,5,12,21,38,23,15,9,17,15,1,0.1,"[0, 20, 40]",0.0003,0.0015,0.001,1
3175,0.023249999999996603,0.5357142857142857,9,23,52,84,54,30,9,17,15,1,0.1,"[0, 20, 40]",0.0003,0.0015,0.001,3
3176,0.028349999999995764,0.5327102803738317,9,27,71,107,74,33,9,17,15,1,0.1,"[0, 20, 40]",0.0003,0.0015,0.001,5
3177,0.007099999999998257,0.47368421052631576,7,3,28,38,23,15,9,17,15,1,0.1,"[0, 20, 40]",0.0003,0.0015,0.0015,1
3178,0.013859999999996042,0.42857142857142855,11,10,63,84,54,30,9,17,15,1,0.1,"[0, 20, 40]",0.0003,0.0015,0.0015,3
3179,0.01829999999999537,0.4392523364485981,12,12,83,107,74,33,9,17,15,1,0.1,"[0, 20, 40]",0.0003,0.0015,0.0015,5
3180,0.013599999999998537,0.5789473684210527,3,12,23,38,23,15,9,17,15,1,0.1,"[0, 20, 40]",0.0003,0.002,0.001,1
3181,0.024669999999996636,0.5238095238095238,6,23,55,84,54,30,9,17,15,1,0.1,"[0, 20, 40]",0.0003,0.002,0.001,3
3182,0.029769999999995796,0.5233644859813084,6,27,74,107,74,33,9,17,15,1,0.1,"[0, 20, 40]",0.0003,0.002,0.001,5
3183,0.00754999999999849,0.4473684210526316,3,3,32,38,23,15,9,17,15,1,0.1,"[0, 20, 40]",0.0003,0.002,0.0015,1
3184,0.015699999999996272,0.4166666666666667,6,10,68,84,54,30,9,17,15,1,0.1,"[0, 20, 40]",0.0003,0.002,0.0015,3
3185,0.02063999999999562,0.42990654205607476,7,12,88,107,74,33,9,17,15,1,0.1,"[0, 20, 40]",0.0003,0.002,0.0015,5
3186,0.006349999999999874,0.8888888888888888,6,2,1,9,5,4,9,17,15,1,0.1,"[0, 20, 40]",0.0005,0.001,0.001,1
3187,0.019209999999999065,0.7435897435897436,14,12,13,39,26,13,9,17,15,1,0.1,"[0, 20, 40]",0.0005,0.001,0.001,3
3188,0.02383999999999813,0.6451612903225806,21,14,27,62,48,14,9,17,15,1,0.1,"[0, 20, 40]",0.0005,0.001,0.001,5
3189,0.004049999999999793,0.7777777777777778,7,0,2,9,5,4,9,17,15,1,0.1,"[0, 20, 40]",0.0005,0.001,0.0015,1
3190,0.0127099999999989,0.6153846153846154,15,6,18,39,26,13,9,17,15,1,0.1,"[0, 20, 40]",0.0005,0.001,0.0015,3
3191,0.01833999999999797,0.5645161290322581,22,8,32,62,48,14,9,17,15,1,0.1,"[0, 20, 40]",0.0005,0.001,0.0015,5
3192,0.0037199999999994664,0.6666666666666666,1,2,6,9,5,4,9,17,15,1,0.1,"[0, 20, 40]",0.0005,0.0015,0.001,1
3193,0.0189699999999985,0.6923076923076923,6,12,21,39,26,13,9,17,15,1,0.1,"[0, 20, 40]",0.0005,0.0015,0.001,3
3194,0.02607999999999721,0.6129032258064516,11,14,37,62,48,14,9,17,15,1,0.1,"[0, 20, 40]",0.0005,0.0015,0.001,5
3195,0.0019199999999993875,0.5555555555555556,2,0,7,9,5,4,9,17,15,1,0.1,"[0, 20, 40]",0.0005,0.0015,0.0015,1
3196,0.012969999999998328,0.5641025641025641,7,6,26,39,26,13,9,17,15,1,0.1,"[0, 20, 40]",0.0005,0.0015,0.0015,3
3197,0.021079999999997046,0.532258064516129,12,8,42,62,48,14,9,17,15,1,0.1,"[0, 20, 40]",0.0005,0.0015,0.0015,5
3198,0.004219999999999466,0.6666666666666666,1,2,6,9,5,4,9,17,15,1,0.1,"[0, 20, 40]",0.0005,0.002,0.001,1
3199,0.020239999999998492,0.6923076923076923,4,12,23,39,26,13,9,17,15,1,0.1,"[0, 20, 40]",0.0005,0.002,0.001,3
3200,0.026929999999996956,0.5967741935483871,6,14,42,62,48,14,9,17,15,1,0.1,"[0, 20, 40]",0.0005,0.002,0.001,5
3201,0.0029199999999993875,0.5555555555555556,2,0,7,9,5,4,9,17,15,1,0.1,"[0, 20, 40]",0.0005,0.002,0.0015,1
3202,0.01473999999999832,0.5641025641025641,5,6,28,39,26,13,9,17,15,1,0.1,"[0, 20, 40]",0.0005,0.002,0.0015,3
3203,0.022429999999996793,0.5161290322580645,7,8,47,62,48,14,9,17,15,1,0.1,"[0, 20, 40]",0.0005,0.002,0.0015,5
3204,0.004519999999999475,0.5882352941176471,5,3,9,17,14,3,9,17,15,1,0.2,"[0, 20, 40]",0.0003,0.001,0.001,1
3205,0.004549999999998205,0.4473684210526316,7,6,25,38,31,7,9,17,15,1,0.2,"[0, 20, 40]",0.0003,0.001,0.001,3
3206,0.009699999999998174,0.4897959183673469,10,9,30,49,41,8,9,17,15,1,0.2,"[0, 20, 40]",0.0003,0.001,0.001,5
3207,0.001779999999999567,0.47058823529411764,5,1,11,17,14,3,9,17,15,1,0.2,"[0, 20, 40]",0.0003,0.001,0.0015,1
3208,0.0012999999999980662,0.3684210526315789,7,3,28,38,31,7,9,17,15,1,0.2,"[0, 20, 40]",0.0003,0.001,0.0015,3
3209,0.005289999999998199,0.40816326530612246,10,5,34,49,41,8,9,17,15,1,0.2,"[0, 20, 40]",0.0003,0.001,0.0015,5
3210,0.006519999999999476,0.5882352941176471,4,4,9,17,14,3,9,17,15,1,0.2,"[0, 20, 40]",0.0003,0.0015,0.001,1
3211,0.006769999999998096,0.4473684210526316,4,7,27,38,31,7,9,17,15,1,0.2,"[0, 20, 40]",0.0003,0.0015,0.001,3
3212,0.010219999999997917,0.46938775510204084,4,10,35,49,41,8,9,17,15,1,0.2,"[0, 20, 40]",0.0003,0.0015,0.001,5
3213,0.0037799999999994565,0.47058823529411764,4,1,12,17,14,3,9,17,15,1,0.2,"[0, 20, 40]",0.0003,0.0015,0.0015,1
3214,0.003519999999997842,0.3684210526315789,4,3,31,38,31,7,9,17,15,1,0.2,"[0, 20, 40]",0.0003,0.0015,0.0015,3
3215,0.005809999999997835,0.3877551020408163,4,5,40,49,41,8,9,17,15,1,0.2,"[0, 20, 40]",0.0003,0.0015,0.0015,5
3216,0.006049999999999507,0.5294117647058824,2,4,11,17,14,3,9,17,15,1,0.2,"[0, 20, 40]",0.0003,0.002,0.001,1
3217,0.006299999999998125,0.42105263157894735,2,7,29,38,31,7,9,17,15,1,0.2,"[0, 20, 40]",0.0003,0.002,0.001,3
3218,0.009749999999997951,0.4489795918367347,2,10,37,49,41,8,9,17,15,1,0.2,"[0, 20, 40]",0.0003,0.002,0.001,5
3219,0.003309999999999488,0.4117647058823529,2,1,14,17,14,3,9,17,15,1,0.2,"[0, 20, 40]",0.0003,0.002,0.0015,1
3220,0.0030499999999978734,0.34210526315789475,2,3,33,38,31,7,9,17,15,1,0.2,"[0, 20, 40]",0.0003,0.002,0.0015,3
3221,0.005339999999997866,0.3673469387755102,2,5,42,49,41,8,9,17,15,1,0.2,"[0, 20, 40]",0.0003,0.002,0.0015,5
3222,0.0023499999999998726,0.75,3,0,1,4,3,1,9,17,15,1,0.2,"[0, 20, 40]",0.0005,0.001,0.001,1
3223,0.007779999999999317,0.6190476190476191,6,5,10,21,18,3,9,17,15,1,0.2,"[0, 20, 40]",0.0005,0.001,0.001,3
3224,0.009189999999998517,0.5151515151515151,8,7,18,33,30,3,9,17,15,1,0.2,"[0, 20, 40]",0.0005,0.001,0.001,5
3225,0.0023499999999998726,0.75,3,0,1,4,3,1,9,17,15,1,0.2,"[0, 20, 40]",0.0005,0.001,0.0015,1
3226,0.005999999999999146,0.5238095238095238,6,3,12,21,18,3,9,17,15,1,0.2,"[0, 20, 40]",0.0005,0.001,0.0015,3
3227,0.008409999999998344,0.45454545454545453,8,5,20,33,30,3,9,17,15,1,0.2,"[0, 20, 40]",0.0005,0.001,0.0015,5
3228,0.001099999999999512,0.5,1,0,3,4,3,1,9,17,15,1,0.2,"[0, 20, 40]",0.0005,0.0015,0.001,1
3229,0.007779999999998928,0.5714285714285714,3,5,13,21,18,3,9,17,15,1,0.2,"[0, 20, 40]",0.0005,0.0015,0.001,3
3230,0.009849999999997958,0.48484848484848486,4,7,22,33,30,3,9,17,15,1,0.2,"[0, 20, 40]",0.0005,0.0015,0.001,5
3231,0.001099999999999512,0.5,1,0,3,4,3,1,9,17,15,1,0.2,"[0, 20, 40]",0.0005,0.0015,0.0015,1
3232,0.005999999999998756,0.47619047619047616,3,3,15,21,18,3,9,17,15,1,0.2,"[0, 20, 40]",0.0005,0.0015,0.0015,3
3233,0.009069999999997783,0.42424242424242425,4,5,24,33,30,3,9,17,15,1,0.2,"[0, 20, 40]",0.0005,0.0015,0.0015,5
3234,0.001599999999999512,0.5,1,0,3,4,3,1,9,17,15,1,0.2,"[0, 20, 40]",0.0005,0.002,0.001,1
3235,0.00754999999999892,0.5714285714285714,1,5,15,21,18,3,9,17,15,1,0.2,"[0, 20, 40]",0.0005,0.002,0.001,3
3236,0.00929999999999791,0.48484848484848486,1,7,25,33,30,3,9,17,15,1,0.2,"[0, 20, 40]",0.0005,0.002,0.001,5
3237,0.001599999999999512,0.5,1,0,3,4,3,1,9,17,15,1,0.2,"[0, 20, 40]",0.0005,0.002,0.0015,1
3238,0.00576999999999875,0.47619047619047616,1,3,17,21,18,3,9,17,15,1,0.2,"[0, 20, 40]",0.0005,0.002,0.0015,3
3239,0.00851999999999774,0.42424242424242425,1,5,27,33,30,3,9,17,15,1,0.2,"[0, 20, 40]",0.0005,0.002,0.0015,5
3240,0.0012299999999992404,0.4074074074074074,5,3,19,27,18,9,9,17,15,2,0.1,"[0, 20, 40]",0.0003,0.001,0.001,1
3241,0.007699999999997837,0.4492753623188406,13,13,43,69,51,18,9,17,15,2,0.1,"[0, 20, 40]",0.0003,0.001,0.001,3
3242,0.013959999999997603,0.47674418604651164,17,17,52,86,67,19,9,17,15,2,0.1,"[0, 20, 40]",0.0003,0.001,0.001,5
3243,0.0016499999999993274,0.4074074074074074,5,2,20,27,18,9,9,17,15,2,0.1,"[0, 20, 40]",0.0003,0.001,0.0015,1
3244,0.00867999999999759,0.42028985507246375,13,10,46,69,51,18,9,17,15,2,0.1,"[0, 20, 40]",0.0003,0.001,0.0015,3
3245,0.013779999999997525,0.4418604651162791,18,12,56,86,67,19,9,17,15,2,0.1,"[0, 20, 40]",0.0003,0.001,0.0015,5
3246,0.0022599999999989946,0.4074074074074074,2,4,21,27,18,9,9,17,15,2,0.1,"[0, 20, 40]",0.0003,0.0015,0.001,1
3247,0.009829999999997249,0.43478260869565216,6,14,49,69,51,18,9,17,15,2,0.1,"[0, 20, 40]",0.0003,0.0015,0.001,3
3248,0.014329999999996809,0.45348837209302323,6,18,62,86,67,19,9,17,15,2,0.1,"[0, 20, 40]",0.0003,0.0015,0.001,5
3249,0.002679999999998971,0.4074074074074074,2,2,23,27,18,9,9,17,15,2,0.1,"[0, 20, 40]",0.0003,0.0015,0.0015,1
3250,0.01080999999999689,0.4057971014492754,6,10,53,69,51,18,9,17,15,2,0.1,"[0, 20, 40]",0.0003,0.0015,0.0015,3
3251,0.014649999999996622,0.4186046511627907,7,12,67,86,67,19,9,17,15,2,0.1,"[0, 20, 40]",0.0003,0.0015,0.0015,5
3252,0.003259999999998994,0.4074074074074074,2,4,21,27,18,9,9,17,15,2,0.1,"[0, 20, 40]",0.0003,0.002,0.001,1
3253,0.012219999999997243,0.43478260869565216,5,14,50,69,51,18,9,17,15,2,0.1,"[0, 20, 40]",0.0003,0.002,0.001,3
3254,0.01671999999999681,0.45348837209302323,5,18,63,86,67,19,9,17,15,2,0.1,"[0, 20, 40]",0.0003,0.002,0.001,5
3255,0.003679999999998971,0.4074074074074074,2,2,23,27,18,9,9,17,15,2,0.1,"[0, 20, 40]",0.0003,0.002,0.0015,1
3256,0.013199999999996883,0.4057971014492754,5,10,54,69,51,18,9,17,15,2,0.1,"[0, 20, 40]",0.0003,0.002,0.0015,3
3257,0.017539999999996624,0.4186046511627907,6,12,68,86,67,19,9,17,15,2,0.1,"[0, 20, 40]",0.0003,0.002,0.0015,5
3258,0.005159999999999939,0.7,6,1,3,10,7,3,9,17,15,2,0.1,"[0, 20, 40]",0.0005,0.001,0.001,1
3259,0.016719999999999326,0.7272727272727273,12,10,11,33,27,6,9,17,15,2,0.1,"[0, 20, 40]",0.0005,0.001,0.001,3
3260,0.022399999999998605,0.6666666666666666,18,12,21,51,45,6,9,17,15,2,0.1,"[0, 20, 40]",0.0005,0.001,0.001,5
3261,0.0028599999999998587,0.6,6,0,4,10,7,3,9,17,15,2,0.1,"[0, 20, 40]",0.0005,0.001,0.0015,1
3262,0.01213999999999896,0.6060606060606061,12,6,15,33,27,6,9,17,15,2,0.1,"[0, 20, 40]",0.0005,0.001,0.0015,3
3263,0.018819999999998248,0.5882352941176471,18,8,25,51,45,6,9,17,15,2,0.1,"[0, 20, 40]",0.0005,0.001,0.0015,5
3264,0.0025299999999995318,0.5,1,1,8,10,7,3,9,17,15,2,0.1,"[0, 20, 40]",0.0005,0.0015,0.001,1
3265,0.015479999999998753,0.6666666666666666,4,10,19,33,27,6,9,17,15,2,0.1,"[0, 20, 40]",0.0005,0.0015,0.001,3
3266,0.023819999999997867,0.6274509803921569,9,12,30,51,45,6,9,17,15,2,0.1,"[0, 20, 40]",0.0005,0.0015,0.001,5
3267,0.00022999999999945308,0.4,1,0,9,10,7,3,9,17,15,2,0.1,"[0, 20, 40]",0.0005,0.0015,0.0015,1
3268,0.010899999999998392,0.5454545454545454,4,6,23,33,27,6,9,17,15,2,0.1,"[0, 20, 40]",0.0005,0.0015,0.0015,3
3269,0.020239999999997507,0.5490196078431373,9,8,34,51,45,6,9,17,15,2,0.1,"[0, 20, 40]",0.0005,0.0015,0.0015,5
3270,0.0030299999999995318,0.5,1,1,8,10,7,3,9,17,15,2,0.1,"[0, 20, 40]",0.0005,0.002,0.001,1
3271,0.01687999999999882,0.6666666666666666,3,10,20,33,27,6,9,17,15,2,0.1,"[0, 20, 40]",0.0005,0.002,0.001,3
3272,0.02479999999999768,0.6078431372549019,5,12,34,51,45,6,9,17,15,2,0.1,"[0, 20, 40]",0.0005,0.002,0.001,5
3273,0.0007299999999994531,0.4,1,0,9,10,7,3,9,17,15,2,0.1,"[0, 20, 40]",0.0005,0.002,0.0015,1
3274,0.012299999999998456,0.5454545454545454,3,6,24,33,27,6,9,17,15,2,0.1,"[0, 20, 40]",0.0005,0.002,0.0015,3
3275,0.021219999999997328,0.5294117647058824,5,8,38,51,45,6,9,17,15,2,0.1,"[0, 20, 40]",0.0005,0.002,0.0015,5
3276,0.0014400000000000623,0.4166666666666667,3,1,8,12,11,1,9,17,15,2,0.2,"[0, 20, 40]",0.0003,0.001,0.001,1
3277,0.004719999999999586,0.45161290322580644,5,7,19,31,27,4,9,17,15,2,0.2,"[0, 20, 40]",0.0003,0.001,0.001,3
3278,0.010529999999999432,0.5238095238095238,7,11,24,42,37,5,9,17,15,2,0.2,"[0, 20, 40]",0.0003,0.001,0.001,5
3279,0.0019400000000000623,0.4166666666666667,3,1,8,12,11,1,9,17,15,2,0.2,"[0, 20, 40]",0.0003,0.001,0.0015,1
3280,0.003779999999999255,0.3870967741935484,5,5,21,31,27,4,9,17,15,2,0.2,"[0, 20, 40]",0.0003,0.001,0.0015,3
3281,0.008429999999999273,0.4523809523809524,8,7,27,42,37,5,9,17,15,2,0.2,"[0, 20, 40]",0.0003,0.001,0.0015,5
3282,0.001989999999999835,0.4166666666666667,1,2,9,12,11,1,9,17,15,2,0.2,"[0, 20, 40]",0.0003,0.0015,0.001,1
3283,0.004749999999999227,0.41935483870967744,2,8,21,31,27,4,9,17,15,2,0.2,"[0, 20, 40]",0.0003,0.0015,0.001,3
3284,0.008879999999999173,0.47619047619047616,2,12,28,42,37,5,9,17,15,2,0.2,"[0, 20, 40]",0.0003,0.0015,0.001,5
3285,0.002489999999999725,0.4166666666666667,1,1,10,12,11,1,9,17,15,2,0.2,"[0, 20, 40]",0.0003,0.0015,0.0015,1
3286,0.0038099999999987866,0.3548387096774194,2,5,24,31,27,4,9,17,15,2,0.2,"[0, 20, 40]",0.0003,0.0015,0.0015,3
3287,0.007279999999998904,0.40476190476190477,3,7,32,42,37,5,9,17,15,2,0.2,"[0, 20, 40]",0.0003,0.0015,0.0015,5
3288,0.0024899999999998352,0.4166666666666667,1,2,9,12,11,1,9,17,15,2,0.2,"[0, 20, 40]",0.0003,0.002,0.001,1
3289,0.005749999999999229,0.41935483870967744,2,8,21,31,27,4,9,17,15,2,0.2,"[0, 20, 40]",0.0003,0.002,0.001,3
3290,0.009879999999999174,0.47619047619047616,2,12,28,42,37,5,9,17,15,2,0.2,"[0, 20, 40]",0.0003,0.002,0.001,5
3291,0.002989999999999725,0.4166666666666667,1,1,10,12,11,1,9,17,15,2,0.2,"[0, 20, 40]",0.0003,0.002,0.0015,1
3292,0.0048099999999987875,0.3548387096774194,2,5,24,31,27,4,9,17,15,2,0.2,"[0, 20, 40]",0.0003,0.002,0.0015,3
3293,0.008779999999998903,0.40476190476190477,3,7,32,42,37,5,9,17,15,2,0.2,"[0, 20, 40]",0.0003,0.002,0.0015,5
3294,0.0005499999999998725,0.3333333333333333,1,0,2,3,3,0,9,17,15,2,0.2,"[0, 20, 40]",0.0005,0.001,0.001,1
3295,0.0060499999999995314,0.625,3,5,8,16,15,1,9,17,15,2,0.2,"[0, 20, 40]",0.0005,0.001,0.001,3
3296,0.009849999999999063,0.5714285714285714,7,7,14,28,27,1,9,17,15,2,0.2,"[0, 20, 40]",0.0005,0.001,0.001,5
3297,0.0005499999999998725,0.3333333333333333,1,0,2,3,3,0,9,17,15,2,0.2,"[0, 20, 40]",0.0005,0.001,0.0015,1
3298,0.004649999999999183,0.5,3,3,10,16,15,1,9,17,15,2,0.2,"[0, 20, 40]",0.0005,0.001,0.0015,3
3299,0.009449999999998718,0.5,7,5,16,28,27,1,9,17,15,2,0.2,"[0, 20, 40]",0.0005,0.001,0.0015,5
3300,0.0004999999999996569,0.3333333333333333,0,0,3,3,3,0,9,17,15,2,0.2,"[0, 20, 40]",0.0005,0.0015,0.001,1
3301,0.006749999999999288,0.625,1,5,10,16,15,1,9,17,15,2,0.2,"[0, 20, 40]",0.0005,0.0015,0.001,3
3302,0.01220999999999865,0.5714285714285714,4,7,17,28,27,1,9,17,15,2,0.2,"[0, 20, 40]",0.0005,0.0015,0.001,5
3303,0.0004999999999996569,0.3333333333333333,0,0,3,3,3,0,9,17,15,2,0.2,"[0, 20, 40]",0.0005,0.0015,0.0015,1
3304,0.005349999999998941,0.5,1,3,12,16,15,1,9,17,15,2,0.2,"[0, 20, 40]",0.0005,0.0015,0.0015,3
3305,0.011809999999998298,0.5,4,5,19,28,27,1,9,17,15,2,0.2,"[0, 20, 40]",0.0005,0.0015,0.0015,5
3306,0.0004999999999996569,0.3333333333333333,0,0,3,3,3,0,9,17,15,2,0.2,"[0, 20, 40]",0.0005,0.002,0.001,1
3307,0.007249999999999288,0.625,1,5,10,16,15,1,9,17,15,2,0.2,"[0, 20, 40]",0.0005,0.002,0.001,3
3308,0.013129999999998462,0.5714285714285714,2,7,19,28,27,1,9,17,15,2,0.2,"[0, 20, 40]",0.0005,0.002,0.001,5
3309,0.0004999999999996569,0.3333333333333333,0,0,3,3,3,0,9,17,15,2,0.2,"[0, 20, 40]",0.0005,0.002,0.0015,1
3310,0.005849999999998941,0.5,1,3,12,16,15,1,9,17,15,2,0.2,"[0, 20, 40]",0.0005,0.002,0.0015,3
3311,0.012729999999998111,0.5,2,5,21,28,27,1,9,17,15,2,0.2,"[0, 20, 40]",0.0005,0.002,0.0015,5
3312,0.017019999999999865,0.6756756756756757,12,12,13,37,23,14,9,17,20,1,0.1,"[0, 20, 40]",0.0003,0.001,0.001,1
3313,0.02768999999999905,0.6447368421052632,22,23,31,76,50,26,9,17,20,1,0.1,"[0, 20, 40]",0.0003,0.001,0.001,3
3314,0.037419999999998475,0.6632653061224489,30,28,40,98,69,29,9,17,20,1,0.1,"[0, 20, 40]",0.0003,0.001,0.001,5
3315,0.015029999999999877,0.5675675675675675,13,7,17,37,23,14,9,17,20,1,0.1,"[0, 20, 40]",0.0003,0.001,0.0015,1
3316,0.019039999999999068,0.5131578947368421,22,13,41,76,50,26,9,17,20,1,0.1,"[0, 20, 40]",0.0003,0.001,0.0015,3
3317,0.03138999999999854,0.5714285714285714,31,17,50,98,68,30,9,17,20,1,0.1,"[0, 20, 40]",0.0003,0.001,0.0015,5
3318,0.020139999999999703,0.6756756756756757,7,14,16,37,23,14,9,17,20,1,0.1,"[0, 20, 40]",0.0003,0.0015,0.001,1
3319,0.029449999999998366,0.6052631578947368,10,26,40,76,50,26,9,17,20,1,0.1,"[0, 20, 40]",0.0003,0.0015,0.001,3
3320,0.03966999999999757,0.6224489795918368,14,32,52,98,69,29,9,17,20,1,0.1,"[0, 20, 40]",0.0003,0.0015,0.001,5
3321,0.019649999999999713,0.5675675675675675,10,7,20,37,23,14,9,17,20,1,0.1,"[0, 20, 40]",0.0003,0.0015,0.0015,1
3322,0.022299999999998384,0.47368421052631576,12,14,50,76,50,26,9,17,20,1,0.1,"[0, 20, 40]",0.0003,0.0015,0.0015,3
3323,0.03407999999999752,0.5204081632653061,17,18,63,98,68,30,9,17,20,1,0.1,"[0, 20, 40]",0.0003,0.0015,0.0015,5
3324,0.02036999999999938,0.6756756756756757,3,14,20,37,23,14,9,17,20,1,0.1,"[0, 20, 40]",0.0003,0.002,0.001,1
3325,0.03122999999999816,0.6052631578947368,6,26,44,76,50,26,9,17,20,1,0.1,"[0, 20, 40]",0.0003,0.002,0.001,3
3326,0.03987999999999721,0.6185567010309279,7,31,59,97,69,28,9,17,20,1,0.1,"[0, 20, 40]",0.0003,0.002,0.001,5
3327,0.020589999999999546,0.5675675675675675,5,7,25,37,23,14,9,17,20,1,0.1,"[0, 20, 40]",0.0003,0.002,0.0015,1
3328,0.02507999999999817,0.47368421052631576,8,14,54,76,50,26,9,17,20,1,0.1,"[0, 20, 40]",0.0003,0.002,0.0015,3
3329,0.03528999999999716,0.5154639175257731,10,17,70,97,68,29,9,17,20,1,0.1,"[0, 20, 40]",0.0003,0.002,0.0015,5
3330,0.006289999999999924,0.8888888888888888,6,2,1,9,5,4,9,17,20,1,0.1,"[0, 20, 40]",0.0005,0.001,0.001,1
3331,0.017159999999999696,0.7222222222222222,13,11,12,36,25,11,9,17,20,1,0.1,"[0, 20, 40]",0.0005,0.001,0.001,3
3332,0.02532999999999896,0.6779661016949152,21,15,23,59,47,12,9,17,20,1,0.1,"[0, 20, 40]",0.0005,0.001,0.001,5
3333,0.004649999999999727,0.7777777777777778,7,0,2,9,5,4,9,17,20,1,0.1,"[0, 20, 40]",0.0005,0.001,0.0015,1
3334,0.016369999999999458,0.6388888888888888,14,7,15,36,25,11,9,17,20,1,0.1,"[0, 20, 40]",0.0005,0.001,0.0015,3
3335,0.024279999999998636,0.6101694915254238,22,10,27,59,47,12,9,17,20,1,0.1,"[0, 20, 40]",0.0005,0.001,0.0015,5
3336,0.005649999999999786,0.6666666666666666,1,3,5,9,5,4,9,17,20,1,0.1,"[0, 20, 40]",0.0005,0.0015,0.001,1
3337,0.018299999999999504,0.6666666666666666,6,12,18,36,25,11,9,17,20,1,0.1,"[0, 20, 40]",0.0005,0.0015,0.001,3
3338,0.028719999999998354,0.6440677966101694,11,16,32,59,47,12,9,17,20,1,0.1,"[0, 20, 40]",0.0005,0.0015,0.001,5
3339,0.002689999999999547,0.4444444444444444,2,0,7,9,5,4,9,17,20,1,0.1,"[0, 20, 40]",0.0005,0.0015,0.0015,1
3340,0.01618999999999922,0.5555555555555556,7,7,22,36,25,11,9,17,20,1,0.1,"[0, 20, 40]",0.0005,0.0015,0.0015,3
3341,0.026349999999997993,0.559322033898305,12,10,37,59,47,12,9,17,20,1,0.1,"[0, 20, 40]",0.0005,0.0015,0.0015,5
3342,0.006149999999999786,0.6666666666666666,1,3,5,9,5,4,9,17,20,1,0.1,"[0, 20, 40]",0.0005,0.002,0.001,1
3343,0.020579999999999453,0.6666666666666666,5,12,19,36,25,11,9,17,20,1,0.1,"[0, 20, 40]",0.0005,0.002,0.001,3
3344,0.03065999999999769,0.6440677966101694,7,16,36,59,47,12,9,17,20,1,0.1,"[0, 20, 40]",0.0005,0.002,0.001,5
3345,0.003689999999999547,0.4444444444444444,2,0,7,9,5,4,9,17,20,1,0.1,"[0, 20, 40]",0.0005,0.002,0.0015,1
3346,0.018969999999999168,0.5555555555555556,6,7,23,36,25,11,9,17,20,1,0.1,"[0, 20, 40]",0.0005,0.002,0.0015,3
3347,0.028789999999997325,0.559322033898305,8,10,41,59,47,12,9,17,20,1,0.1,"[0, 20, 40]",0.0005,0.002,0.0015,5
3348,0.007219999999999956,0.6470588235294118,7,4,6,17,14,3,9,17,20,1,0.2,"[0, 20, 40]",0.0003,0.001,0.001,1
3349,0.009239999999999778,0.5555555555555556,10,8,18,36,29,7,9,17,20,1,0.2,"[0, 20, 40]",0.0003,0.001,0.001,3
3350,0.015139999999999675,0.6086956521739131,14,11,21,46,38,8,9,17,20,1,0.2,"[0, 20, 40]",0.0003,0.001,0.001,5
3351,0.007419999999999765,0.5882352941176471,7,3,7,17,14,3,9,17,20,1,0.2,"[0, 20, 40]",0.0003,0.001,0.0015,1
3352,0.00720999999999952,0.4722222222222222,10,5,21,36,29,7,9,17,20,1,0.2,"[0, 20, 40]",0.0003,0.001,0.0015,3
3353,0.014609999999999417,0.5434782608695652,14,8,24,46,38,8,9,17,20,1,0.2,"[0, 20, 40]",0.0003,0.001,0.0015,5
3354,0.009349999999999864,0.6470588235294118,5,5,7,17,14,3,9,17,20,1,0.2,"[0, 20, 40]",0.0003,0.0015,0.001,1
3355,0.011579999999999395,0.5555555555555556,5,9,22,36,29,7,9,17,20,1,0.2,"[0, 20, 40]",0.0003,0.0015,0.001,3
3356,0.017979999999999236,0.6086956521739131,7,13,26,46,38,8,9,17,20,1,0.2,"[0, 20, 40]",0.0003,0.0015,0.001,5
3357,0.010049999999999674,0.5882352941176471,6,3,8,17,14,3,9,17,20,1,0.2,"[0, 20, 40]",0.0003,0.0015,0.0015,1
3358,0.01004999999999914,0.4722222222222222,6,5,25,36,29,7,9,17,20,1,0.2,"[0, 20, 40]",0.0003,0.0015,0.0015,3
3359,0.016389999999998864,0.5217391304347826,8,8,30,46,38,8,9,17,20,1,0.2,"[0, 20, 40]",0.0003,0.0015,0.0015,5
3360,0.009139999999999657,0.6470588235294118,2,5,10,17,14,3,9,17,20,1,0.2,"[0, 20, 40]",0.0003,0.002,0.001,1
3361,0.012409999999999336,0.5555555555555556,3,9,24,36,29,7,9,17,20,1,0.2,"[0, 20, 40]",0.0003,0.002,0.001,3
3362,0.017019999999999022,0.6,3,12,30,45,38,7,9,17,20,1,0.2,"[0, 20, 40]",0.0003,0.002,0.001,5
3363,0.010339999999999466,0.5882352941176471,3,3,11,17,14,3,9,17,20,1,0.2,"[0, 20, 40]",0.0003,0.002,0.0015,1
3364,0.011379999999999084,0.4722222222222222,4,5,27,36,29,7,9,17,20,1,0.2,"[0, 20, 40]",0.0003,0.002,0.0015,3
3365,0.015429999999998653,0.5111111111111111,4,7,34,45,38,7,9,17,20,1,0.2,"[0, 20, 40]",0.0003,0.002,0.0015,5
3366,0.0022899999999999236,0.75,3,0,1,4,3,1,9,17,20,1,0.2,"[0, 20, 40]",0.0005,0.001,0.001,1
3367,0.007849999999999776,0.6190476190476191,6,5,10,21,18,3,9,17,20,1,0.2,"[0, 20, 40]",0.0005,0.001,0.001,3
3368,0.011689999999999348,0.6060606060606061,9,8,16,33,30,3,9,17,20,1,0.2,"[0, 20, 40]",0.0005,0.001,0.001,5
3369,0.0022899999999999236,0.75,3,0,1,4,3,1,9,17,20,1,0.2,"[0, 20, 40]",0.0005,0.001,0.0015,1
3370,0.008839999999999707,0.5714285714285714,6,4,11,21,18,3,9,17,20,1,0.2,"[0, 20, 40]",0.0005,0.001,0.0015,3
3371,0.01191999999999919,0.5454545454545454,9,6,18,33,30,3,9,17,20,1,0.2,"[0, 20, 40]",0.0005,0.001,0.0015,5
3372,0.00261999999999981,0.75,1,1,2,4,3,1,9,17,20,1,0.2,"[0, 20, 40]",0.0005,0.0015,0.001,1
3373,0.009679999999999661,0.6190476190476191,4,6,11,21,18,3,9,17,20,1,0.2,"[0, 20, 40]",0.0005,0.0015,0.001,3
3374,0.013779999999998994,0.6060606060606061,5,9,19,33,30,3,9,17,20,1,0.2,"[0, 20, 40]",0.0005,0.0015,0.001,5
3375,0.0007999999999997668,0.5,1,0,3,4,3,1,9,17,20,1,0.2,"[0, 20, 40]",0.0005,0.0015,0.0015,1
3376,0.00884999999999955,0.5238095238095238,4,4,13,21,18,3,9,17,20,1,0.2,"[0, 20, 40]",0.0005,0.0015,0.0015,3
3377,0.012189999999998792,0.5151515151515151,5,6,22,33,30,3,9,17,20,1,0.2,"[0, 20, 40]",0.0005,0.0015,0.0015,5
3378,0.00311999999999981,0.75,1,1,2,4,3,1,9,17,20,1,0.2,"[0, 20, 40]",0.0005,0.002,0.001,1
3379,0.010959999999999609,0.6190476190476191,3,6,12,21,18,3,9,17,20,1,0.2,"[0, 20, 40]",0.0005,0.002,0.001,3
3380,0.014339999999998724,0.6060606060606061,3,9,21,33,30,3,9,17,20,1,0.2,"[0, 20, 40]",0.0005,0.002,0.001,5
3381,0.0012999999999997668,0.5,1,0,3,4,3,1,9,17,20,1,0.2,"[0, 20, 40]",0.0005,0.002,0.0015,1
3382,0.010129999999999497,0.5238095238095238,3,4,14,21,18,3,9,17,20,1,0.2,"[0, 20, 40]",0.0005,0.002,0.0015,3
3383,0.012749999999998521,0.5151515151515151,3,6,24,33,30,3,9,17,20,1,0.2,"[0, 20, 40]",0.0005,0.002,0.0015,5
3384,0.0082099999999998,0.5384615384615384,7,6,13,26,18,8,9,17,20,2,0.1,"[0, 20, 40]",0.0003,0.001,0.001,1
3385,0.018939999999999093,0.5555555555555556,15,16,32,63,47,16,9,17,20,2,0.1,"[0, 20, 40]",0.0003,0.001,0.001,3
3386,0.027709999999998878,0.6,22,21,37,80,63,17,9,17,20,2,0.1,"[0, 20, 40]",0.0003,0.001,0.001,5
3387,0.009869999999999962,0.5,7,5,14,26,18,8,9,17,20,2,0.1,"[0, 20, 40]",0.0003,0.001,0.0015,1
3388,0.021369999999999195,0.5079365079365079,15,13,35,63,47,16,9,17,20,2,0.1,"[0, 20, 40]",0.0003,0.001,0.0015,3
3389,0.03235999999999911,0.569620253164557,23,17,39,79,62,17,9,17,20,2,0.1,"[0, 20, 40]",0.0003,0.001,0.0015,5
3390,0.009329999999999646,0.5384615384615384,3,7,16,26,18,8,9,17,20,2,0.1,"[0, 20, 40]",0.0003,0.0015,0.001,1
3391,0.018629999999998457,0.5238095238095238,5,18,40,63,47,16,9,17,20,2,0.1,"[0, 20, 40]",0.0003,0.0015,0.001,3
3392,0.028549999999997997,0.575,9,24,47,80,63,17,9,17,20,2,0.1,"[0, 20, 40]",0.0003,0.0015,0.001,5
3393,0.011489999999999802,0.5,4,5,17,26,18,8,9,17,20,2,0.1,"[0, 20, 40]",0.0003,0.0015,0.0015,1
3394,0.022059999999998553,0.47619047619047616,6,14,43,63,47,16,9,17,20,2,0.1,"[0, 20, 40]",0.0003,0.0015,0.0015,3
3395,0.033139999999998115,0.5316455696202531,11,18,50,79,62,17,9,17,20,2,0.1,"[0, 20, 40]",0.0003,0.0015,0.0015,5
3396,0.010269999999999531,0.5384615384615384,2,7,17,26,18,8,9,17,20,2,0.1,"[0, 20, 40]",0.0003,0.002,0.001,1
3397,0.019579999999998297,0.5238095238095238,3,18,42,63,47,16,9,17,20,2,0.1,"[0, 20, 40]",0.0003,0.002,0.001,3
3398,0.028729999999997688,0.575,4,24,52,80,63,17,9,17,20,2,0.1,"[0, 20, 40]",0.0003,0.002,0.001,5
3399,0.012929999999999688,0.5,3,5,18,26,18,8,9,17,20,2,0.1,"[0, 20, 40]",0.0003,0.002,0.0015,1
3400,0.023509999999998393,0.47619047619047616,4,14,45,63,47,16,9,17,20,2,0.1,"[0, 20, 40]",0.0003,0.002,0.0015,3
3401,0.034319999999997804,0.5316455696202531,6,18,55,79,62,17,9,17,20,2,0.1,"[0, 20, 40]",0.0003,0.002,0.0015,5
3402,0.0064100000000000225,0.8,6,2,2,10,7,3,9,17,20,2,0.1,"[0, 20, 40]",0.0005,0.001,0.001,1
3403,0.018589999999999936,0.78125,12,11,9,32,26,6,9,17,20,2,0.1,"[0, 20, 40]",0.0005,0.001,0.001,3
3404,0.02649999999999961,0.74,19,14,17,50,44,6,9,17,20,2,0.1,"[0, 20, 40]",0.0005,0.001,0.001,5
3405,0.005269999999999825,0.7,6,1,3,10,7,3,9,17,20,2,0.1,"[0, 20, 40]",0.0005,0.001,0.0015,1
3406,0.018269999999999727,0.6875,12,8,12,32,26,6,9,17,20,2,0.1,"[0, 20, 40]",0.0005,0.001,0.0015,3
3407,0.02541999999999931,0.66,19,10,21,50,44,6,9,17,20,2,0.1,"[0, 20, 40]",0.0005,0.001,0.0015,5
3408,0.005769999999999884,0.6,1,3,6,10,7,3,9,17,20,2,0.1,"[0, 20, 40]",0.0005,0.0015,0.001,1
3409,0.01891999999999955,0.71875,4,12,16,32,26,6,9,17,20,2,0.1,"[0, 20, 40]",0.0005,0.0015,0.001,3
3410,0.029089999999998985,0.7,9,15,26,50,44,6,9,17,20,2,0.1,"[0, 20, 40]",0.0005,0.0015,0.001,5
3411,0.002809999999999645,0.4,1,1,8,10,7,3,9,17,20,2,0.1,"[0, 20, 40]",0.0005,0.0015,0.0015,1
3412,0.016779999999999292,0.59375,4,8,20,32,26,6,9,17,20,2,0.1,"[0, 20, 40]",0.0005,0.0015,0.0015,3
3413,0.02618999999999865,0.6,9,10,31,50,44,6,9,17,20,2,0.1,"[0, 20, 40]",0.0005,0.0015,0.0015,5
3414,0.006269999999999883,0.6,1,3,6,10,7,3,9,17,20,2,0.1,"[0, 20, 40]",0.0005,0.002,0.001,1
3415,0.020199999999999496,0.71875,3,12,17,32,26,6,9,17,20,2,0.1,"[0, 20, 40]",0.0005,0.002,0.001,3
3416,0.030029999999998322,0.7,5,15,30,50,44,6,9,17,20,2,0.1,"[0, 20, 40]",0.0005,0.002,0.001,5
3417,0.003309999999999645,0.4,1,1,8,10,7,3,9,17,20,2,0.1,"[0, 20, 40]",0.0005,0.002,0.0015,1
3418,0.01805999999999924,0.59375,3,8,21,32,26,6,9,17,20,2,0.1,"[0, 20, 40]",0.0005,0.002,0.0015,3
3419,0.02712999999999798,0.6,5,10,35,50,44,6,9,17,20,2,0.1,"[0, 20, 40]",0.0005,0.002,0.0015,5
3420,0.0033799999999998913,0.5,4,2,6,12,11,1,9,17,20,2,0.2,"[0, 20, 40]",0.0003,0.001,0.001,1
3421,0.007530000000000211,0.5185185185185185,5,8,14,27,24,3,9,17,20,2,0.2,"[0, 20, 40]",0.0003,0.001,0.001,3
3422,0.01423000000000011,0.6052631578947368,9,12,17,38,34,4,9,17,20,2,0.2,"[0, 20, 40]",0.0003,0.001,0.001,5
3423,0.004379999999999891,0.5,4,2,6,12,11,1,9,17,20,2,0.2,"[0, 20, 40]",0.0003,0.001,0.0015,1
3424,0.007300000000000143,0.4444444444444444,5,6,16,27,24,3,9,17,20,2,0.2,"[0, 20, 40]",0.0003,0.001,0.0015,3
3425,0.015500000000000043,0.5526315789473685,10,9,19,38,34,4,9,17,20,2,0.2,"[0, 20, 40]",0.0003,0.001,0.0015,5
3426,0.004009999999999799,0.5,2,3,7,12,11,1,9,17,20,2,0.2,"[0, 20, 40]",0.0003,0.0015,0.001,1
3427,0.007500000000000071,0.5185185185185185,1,10,16,27,24,3,9,17,20,2,0.2,"[0, 20, 40]",0.0003,0.0015,0.001,3
3428,0.014699999999999913,0.6052631578947368,3,15,20,38,34,4,9,17,20,2,0.2,"[0, 20, 40]",0.0003,0.0015,0.001,5
3429,0.005509999999999799,0.5,3,2,7,12,11,1,9,17,20,2,0.2,"[0, 20, 40]",0.0003,0.0015,0.0015,1
3430,0.008270000000000003,0.4444444444444444,2,7,18,27,24,3,9,17,20,2,0.2,"[0, 20, 40]",0.0003,0.0015,0.0015,3
3431,0.01590999999999973,0.5263157894736842,5,10,23,38,34,4,9,17,20,2,0.2,"[0, 20, 40]",0.0003,0.0015,0.0015,5
3432,0.004449999999999685,0.5,1,3,8,12,11,1,9,17,20,2,0.2,"[0, 20, 40]",0.0003,0.002,0.001,1
3433,0.007439999999999956,0.5185185185185185,0,10,17,27,24,3,9,17,20,2,0.2,"[0, 20, 40]",0.0003,0.002,0.001,3
3434,0.014589999999999806,0.6052631578947368,1,15,22,38,34,4,9,17,20,2,0.2,"[0, 20, 40]",0.0003,0.002,0.001,5
3435,0.006449999999999683,0.5,2,2,8,12,11,1,9,17,20,2,0.2,"[0, 20, 40]",0.0003,0.002,0.0015,1
3436,0.00870999999999989,0.4444444444444444,1,7,19,27,24,3,9,17,20,2,0.2,"[0, 20, 40]",0.0003,0.002,0.0015,3
3437,0.01679999999999962,0.5263157894736842,3,10,25,38,34,4,9,17,20,2,0.2,"[0, 20, 40]",0.0003,0.002,0.0015,5
3438,0.0014899999999999237,0.6666666666666666,1,1,1,3,3,0,9,17,20,2,0.2,"[0, 20, 40]",0.0005,0.001,0.001,1
3439,0.006489999999999992,0.6666666666666666,2,6,7,15,14,1,9,17,20,2,0.2,"[0, 20, 40]",0.0005,0.001,0.001,3
3440,0.01334999999999981,0.7037037037037037,7,9,11,27,26,1,9,17,20,2,0.2,"[0, 20, 40]",0.0005,0.001,0.001,5
3441,0.0019899999999999233,0.6666666666666666,1,1,1,3,3,0,9,17,20,2,0.2,"[0, 20, 40]",0.0005,0.001,0.0015,1
3442,0.005809999999999977,0.5333333333333333,2,4,9,15,14,1,9,17,20,2,0.2,"[0, 20, 40]",0.0005,0.001,0.0015,3
3443,0.011909999999999697,0.5925925925925926,7,6,14,27,26,1,9,17,20,2,0.2,"[0, 20, 40]",0.0005,0.001,0.0015,5
3444,0.00131999999999981,0.6666666666666666,0,1,2,3,3,0,9,17,20,2,0.2,"[0, 20, 40]",0.0005,0.0015,0.001,1
3445,0.006819999999999878,0.6666666666666666,1,6,8,15,14,1,9,17,20,2,0.2,"[0, 20, 40]",0.0005,0.0015,0.001,3
3446,0.014939999999999457,0.7037037037037037,4,9,14,27,26,1,9,17,20,2,0.2,"[0, 20, 40]",0.0005,0.0015,0.001,5
3447,0.0018199999999998098,0.6666666666666666,0,1,2,3,3,0,9,17,20,2,0.2,"[0, 20, 40]",0.0005,0.0015,0.0015,1
3448,0.0061399999999998634,0.5333333333333333,1,4,10,15,14,1,9,17,20,2,0.2,"[0, 20, 40]",0.0005,0.0015,0.0015,3
3449,0.013499999999999342,0.5925925925925926,4,6,17,27,26,1,9,17,20,2,0.2,"[0, 20, 40]",0.0005,0.0015,0.0015,5
3450,0.00131999999999981,0.6666666666666666,0,1,2,3,3,0,9,17,20,2,0.2,"[0, 20, 40]",0.0005,0.002,0.001,1
3451,0.007319999999999879,0.6666666666666666,1,6,8,15,14,1,9,17,20,2,0.2,"[0, 20, 40]",0.0005,0.002,0.001,3
3452,0.015319999999999062,0.7037037037037037,2,9,16,27,26,1,9,17,20,2,0.2,"[0, 20, 40]",0.0005,0.002,0.001,5
3453,0.0018199999999998098,0.6666666666666666,0,1,2,3,3,0,9,17,20,2,0.2,"[0, 20, 40]",0.0005,0.002,0.0015,1
3454,0.006639999999999863,0.5333333333333333,1,4,10,15,14,1,9,17,20,2,0.2,"[0, 20, 40]",0.0005,0.002,0.0015,3
3455,0.013879999999998949,0.5925925925925926,2,6,19,27,26,1,9,17,20,2,0.2,"[0, 20, 40]",0.0005,0.002,0.0015,5
3456,0.005229999999998934,0.3870967741935484,5,5,21,31,17,14,10,15,5,1,0.1,"[0, 20, 40]",0.0003,0.001,0.001,1
3457,-2.176319020830153e-15,0.2857142857142857,6,7,50,63,36,27,10,15,5,1,0.1,"[0, 20, 40]",0.0003,0.001,0.001,3
3458,-0.002360000000003207,0.2564102564102564,6,8,64,78,49,29,10,15,5,1,0.1,"[0, 20, 40]",0.0003,0.001,0.001,5
3459,0.0033699999999989047,0.3225806451612903,5,3,23,31,17,14,10,15,5,1,0.1,"[0, 20, 40]",0.0003,0.001,0.0015,1
3460,-0.005850000000002361,0.2222222222222222,6,3,54,63,36,27,10,15,5,1,0.1,"[0, 20, 40]",0.0003,0.001,0.0015,3
3461,-0.008210000000003393,0.20512820512820512,7,3,68,78,49,29,10,15,5,1,0.1,"[0, 20, 40]",0.0003,0.001,0.0015,5
3462,0.003939999999998703,0.3548387096774194,0,6,25,31,17,14,10,15,5,1,0.1,"[0, 20, 40]",0.0003,0.0015,0.001,1
3463,-0.0012200000000025042,0.2698412698412698,0,8,55,63,36,27,10,15,5,1,0.1,"[0, 20, 40]",0.0003,0.0015,0.001,3
3464,-0.0035800000000035343,0.24358974358974358,0,9,69,78,49,29,10,15,5,1,0.1,"[0, 20, 40]",0.0003,0.0015,0.001,5
3465,0.0005599999999988172,0.25806451612903225,0,3,28,31,17,14,10,15,5,1,0.1,"[0, 20, 40]",0.0003,0.0015,0.0015,1
3466,-0.008590000000002545,0.19047619047619047,0,3,60,63,36,27,10,15,5,1,0.1,"[0, 20, 40]",0.0003,0.0015,0.0015,3
3467,-0.010850000000003699,0.1794871794871795,0,3,75,78,49,29,10,15,5,1,0.1,"[0, 20, 40]",0.0003,0.0015,0.0015,5
3468,0.003939999999998703,0.3548387096774194,0,6,25,31,17,14,10,15,5,1,0.1,"[0, 20, 40]",0.0003,0.002,0.001,1
3469,-0.0012200000000025042,0.2698412698412698,0,8,55,63,36,27,10,15,5,1,0.1,"[0, 20, 40]",0.0003,0.002,0.001,3
3470,-0.0035800000000035343,0.24358974358974358,0,9,69,78,49,29,10,15,5,1,0.1,"[0, 20, 40]",0.0003,0.002,0.001,5
3471,0.0005599999999988172,0.25806451612903225,0,3,28,31,17,14,10,15,5,1,0.1,"[0, 20, 40]",0.0003,0.002,0.0015,1
3472,-0.008590000000002545,0.19047619047619047,0,3,60,63,36,27,10,15,5,1,0.1,"[0, 20, 40]",0.0003,0.002,0.0015,3
3473,-0.010850000000003699,0.1794871794871795,0,3,75,78,49,29,10,15,5,1,0.1,"[0, 20, 40]",0.0003,0.002,0.0015,5
3474,0.0016799999999995256,0.7142857142857143,1,1,5,7,4,3,10,15,5,1,0.1,"[0, 20, 40]",0.0005,0.001,0.001,1
3475,0.005379999999998631,0.5517241379310345,5,5,19,29,18,11,10,15,5,1,0.1,"[0, 20, 40]",0.0005,0.001,0.001,3
3476,0.0027499999999976506,0.47619047619047616,6,5,31,42,30,12,10,15,5,1,0.1,"[0, 20, 40]",0.0005,0.001,0.001,5
3477,-0.0006000000000006442,0.5714285714285714,1,0,6,7,4,3,10,15,5,1,0.1,"[0, 20, 40]",0.0005,0.001,0.0015,1
3478,-0.004770000000001805,0.3793103448275862,5,0,24,29,18,11,10,15,5,1,0.1,"[0, 20, 40]",0.0005,0.001,0.0015,3
3479,-0.007400000000002778,0.35714285714285715,6,0,36,42,30,12,10,15,5,1,0.1,"[0, 20, 40]",0.0005,0.001,0.0015,5
3480,0.0007099999999995003,0.5714285714285714,0,1,6,7,4,3,10,15,5,1,0.1,"[0, 20, 40]",0.0005,0.0015,0.001,1
3481,0.0037899999999984843,0.4827586206896552,1,5,23,29,18,11,10,15,5,1,0.1,"[0, 20, 40]",0.0005,0.0015,0.001,3
3482,0.0014599999999973636,0.42857142857142855,1,5,36,42,30,12,10,15,5,1,0.1,"[0, 20, 40]",0.0005,0.0015,0.001,5
3483,-0.0015700000000006698,0.42857142857142855,0,0,7,7,4,3,10,15,5,1,0.1,"[0, 20, 40]",0.0005,0.0015,0.0015,1
3484,-0.006360000000001949,0.3103448275862069,1,0,28,29,18,11,10,15,5,1,0.1,"[0, 20, 40]",0.0005,0.0015,0.0015,3
3485,-0.008690000000003067,0.30952380952380953,1,0,41,42,30,12,10,15,5,1,0.1,"[0, 20, 40]",0.0005,0.0015,0.0015,5
3486,0.0007099999999995003,0.5714285714285714,0,1,6,7,4,3,10,15,5,1,0.1,"[0, 20, 40]",0.0005,0.002,0.001,1
3487,0.00404999999999847,0.4827586206896552,0,5,24,29,18,11,10,15,5,1,0.1,"[0, 20, 40]",0.0005,0.002,0.001,3
3488,0.0017199999999973478,0.42857142857142855,0,5,37,42,30,12,10,15,5,1,0.1,"[0, 20, 40]",0.0005,0.002,0.001,5
3489,-0.0015700000000006698,0.42857142857142855,0,0,7,7,4,3,10,15,5,1,0.1,"[0, 20, 40]",0.0005,0.002,0.0015,1
3490,-0.006100000000001966,0.3103448275862069,0,0,29,29,18,11,10,15,5,1,0.1,"[0, 20, 40]",0.0005,0.002,0.0015,3
3491,-0.008430000000003083,0.30952380952380953,0,0,42,42,30,12,10,15,5,1,0.1,"[0, 20, 40]",0.0005,0.002,0.0015,5
3492,0.004039999999999597,0.4666666666666667,3,2,10,15,12,3,10,15,5,1,0.2,"[0, 20, 40]",0.0003,0.001,0.001,1
3493,1.9999999999287515e-05,0.35714285714285715,3,3,22,28,21,7,10,15,5,1,0.2,"[0, 20, 40]",0.0003,0.001,0.001,3
3494,-0.002050000000000884,0.2857142857142857,3,3,29,35,27,8,10,15,5,1,0.2,"[0, 20, 40]",0.0003,0.001,0.001,5
3495,0.0050399999999996,0.4666666666666667,3,2,10,15,12,3,10,15,5,1,0.2,"[0, 20, 40]",0.0003,0.001,0.0015,1
3496,-0.0007600000000007166,0.32142857142857145,3,2,23,28,21,7,10,15,5,1,0.2,"[0, 20, 40]",0.0003,0.001,0.0015,3
3497,-0.0028300000000008874,0.2571428571428571,3,2,30,35,27,8,10,15,5,1,0.2,"[0, 20, 40]",0.0003,0.001,0.0015,5
3498,0.002689999999999526,0.4,0,2,13,15,12,3,10,15,5,1,0.2,"[0, 20, 40]",0.0003,0.0015,0.001,1
3499,-0.0013300000000007837,0.32142857142857145,0,3,25,28,21,7,10,15,5,1,0.2,"[0, 20, 40]",0.0003,0.0015,0.001,3
3500,-0.0034000000000009548,0.2571428571428571,0,3,32,35,27,8,10,15,5,1,0.2,"[0, 20, 40]",0.0003,0.0015,0.001,5
3501,0.0036899999999995274,0.4,0,2,13,15,12,3,10,15,5,1,0.2,"[0, 20, 40]",0.0003,0.0015,0.0015,1
3502,-0.0021100000000007875,0.2857142857142857,0,2,26,28,21,7,10,15,5,1,0.2,"[0, 20, 40]",0.0003,0.0015,0.0015,3
3503,-0.004180000000000958,0.22857142857142856,0,2,33,35,27,8,10,15,5,1,0.2,"[0, 20, 40]",0.0003,0.0015,0.0015,5
3504,0.002689999999999526,0.4,0,2,13,15,12,3,10,15,5,1,0.2,"[0, 20, 40]",0.0003,0.002,0.001,1
3505,-0.0013300000000007837,0.32142857142857145,0,3,25,28,21,7,10,15,5,1,0.2,"[0, 20, 40]",0.0003,0.002,0.001,3
3506,-0.0034000000000009548,0.2571428571428571,0,3,32,35,27,8,10,15,5,1,0.2,"[0, 20, 40]",0.0003,0.002,0.001,5
3507,0.0036899999999995274,0.4,0,2,13,15,12,3,10,15,5,1,0.2,"[0, 20, 40]",0.0003,0.002,0.0015,1
3508,-0.0021100000000007875,0.2857142857142857,0,2,26,28,21,7,10,15,5,1,0.2,"[0, 20, 40]",0.0003,0.002,0.0015,3
3509,-0.004180000000000958,0.22857142857142856,0,2,33,35,27,8,10,15,5,1,0.2,"[0, 20, 40]",0.0003,0.002,0.0015,5
3510,0.0017999999999995797,0.8,0,1,4,5,4,1,10,15,5,1,0.2,"[0, 20, 40]",0.0005,0.001,0.001,1
3511,0.0012899999999990792,0.47058823529411764,2,3,12,17,14,3,10,15,5,1,0.2,"[0, 20, 40]",0.0005,0.001,0.001,3
3512,-0.0003900000000013783,0.4090909090909091,2,3,17,22,19,3,10,15,5,1,0.2,"[0, 20, 40]",0.0005,0.001,0.001,5
3513,-0.0004800000000005905,0.6,0,0,5,5,4,1,10,15,5,1,0.2,"[0, 20, 40]",0.0005,0.001,0.0015,1
3514,-0.005050000000001261,0.29411764705882354,2,0,15,17,14,3,10,15,5,1,0.2,"[0, 20, 40]",0.0005,0.001,0.0015,3
3515,-0.00673000000000172,0.2727272727272727,2,0,20,22,19,3,10,15,5,1,0.2,"[0, 20, 40]",0.0005,0.001,0.0015,5
3516,0.0017999999999995797,0.8,0,1,4,5,4,1,10,15,5,1,0.2,"[0, 20, 40]",0.0005,0.0015,0.001,1
3517,0.0010099999999989662,0.4117647058823529,1,3,13,17,14,3,10,15,5,1,0.2,"[0, 20, 40]",0.0005,0.0015,0.001,3
3518,-0.0006700000000014915,0.36363636363636365,1,3,18,22,19,3,10,15,5,1,0.2,"[0, 20, 40]",0.0005,0.0015,0.001,5
3519,-0.0004800000000005905,0.6,0,0,5,5,4,1,10,15,5,1,0.2,"[0, 20, 40]",0.0005,0.0015,0.0015,1
3520,-0.0053300000000013744,0.23529411764705882,1,0,16,17,14,3,10,15,5,1,0.2,"[0, 20, 40]",0.0005,0.0015,0.0015,3
3521,-0.007010000000001832,0.22727272727272727,1,0,21,22,19,3,10,15,5,1,0.2,"[0, 20, 40]",0.0005,0.0015,0.0015,5
3522,0.0017999999999995797,0.8,0,1,4,5,4,1,10,15,5,1,0.2,"[0, 20, 40]",0.0005,0.002,0.001,1
3523,0.00126999999999895,0.4117647058823529,0,3,14,17,14,3,10,15,5,1,0.2,"[0, 20, 40]",0.0005,0.002,0.001,3
3524,-0.00041000000000150736,0.36363636363636365,0,3,19,22,19,3,10,15,5,1,0.2,"[0, 20, 40]",0.0005,0.002,0.001,5
3525,-0.0004800000000005905,0.6,0,0,5,5,4,1,10,15,5,1,0.2,"[0, 20, 40]",0.0005,0.002,0.0015,1
3526,-0.005070000000001391,0.23529411764705882,0,0,17,17,14,3,10,15,5,1,0.2,"[0, 20, 40]",0.0005,0.002,0.0015,3
3527,-0.006750000000001848,0.22727272727272727,0,0,22,22,19,3,10,15,5,1,0.2,"[0, 20, 40]",0.0005,0.002,0.0015,5
3528,0.0011499999999994067,0.2857142857142857,3,2,16,21,14,7,10,15,5,2,0.1,"[0, 20, 40]",0.0003,0.001,0.001,1
3529,-0.00313000000000201,0.23404255319148937,4,4,39,47,32,15,10,15,5,2,0.1,"[0, 20, 40]",0.0003,0.001,0.001,3
3530,-0.004350000000002825,0.22033898305084745,4,5,50,59,43,16,10,15,5,2,0.1,"[0, 20, 40]",0.0003,0.001,0.001,5
3531,0.002149999999999406,0.2857142857142857,3,2,16,21,14,7,10,15,5,2,0.1,"[0, 20, 40]",0.0003,0.001,0.0015,1
3532,-0.006120000000002164,0.19148936170212766,4,2,41,47,32,15,10,15,5,2,0.1,"[0, 20, 40]",0.0003,0.001,0.0015,3
3533,-0.0073400000000029865,0.1864406779661017,5,2,52,59,43,16,10,15,5,2,0.1,"[0, 20, 40]",0.0003,0.001,0.0015,5
3534,-0.0006400000000006599,0.23809523809523808,0,2,19,21,14,7,10,15,5,2,0.1,"[0, 20, 40]",0.0003,0.0015,0.001,1
3535,-0.004850000000002169,0.2127659574468085,0,4,43,47,32,15,10,15,5,2,0.1,"[0, 20, 40]",0.0003,0.0015,0.001,3
3536,-0.006070000000002987,0.2033898305084746,0,5,54,59,43,16,10,15,5,2,0.1,"[0, 20, 40]",0.0003,0.0015,0.001,5
3537,0.00035999999999933926,0.23809523809523808,0,2,19,21,14,7,10,15,5,2,0.1,"[0, 20, 40]",0.0003,0.0015,0.0015,1
3538,-0.007840000000002326,0.1702127659574468,0,2,45,47,32,15,10,15,5,2,0.1,"[0, 20, 40]",0.0003,0.0015,0.0015,3
3539,-0.008960000000003274,0.1694915254237288,0,2,57,59,43,16,10,15,5,2,0.1,"[0, 20, 40]",0.0003,0.0015,0.0015,5
3540,-0.0006400000000006599,0.23809523809523808,0,2,19,21,14,7,10,15,5,2,0.1,"[0, 20, 40]",0.0003,0.002,0.001,1
3541,-0.004850000000002169,0.2127659574468085,0,4,43,47,32,15,10,15,5,2,0.1,"[0, 20, 40]",0.0003,0.002,0.001,3
3542,-0.006070000000002987,0.2033898305084746,0,5,54,59,43,16,10,15,5,2,0.1,"[0, 20, 40]",0.0003,0.002,0.001,5
3543,0.00035999999999933926,0.23809523809523808,0,2,19,21,14,7,10,15,5,2,0.1,"[0, 20, 40]",0.0003,0.002,0.0015,1
3544,-0.007840000000002326,0.1702127659574468,0,2,45,47,32,15,10,15,5,2,0.1,"[0, 20, 40]",0.0003,0.002,0.0015,3
3545,-0.008960000000003274,0.1694915254237288,0,2,57,59,43,16,10,15,5,2,0.1,"[0, 20, 40]",0.0003,0.002,0.0015,5
3546,0.00174999999999974,0.625,1,1,6,8,6,2,10,15,5,2,0.1,"[0, 20, 40]",0.0005,0.001,0.001,1
3547,0.002669999999999081,0.5,3,4,17,24,19,5,10,15,5,2,0.1,"[0, 20, 40]",0.0005,0.001,0.001,3
3548,0.0021399999999986066,0.47058823529411764,4,4,26,34,29,5,10,15,5,2,0.1,"[0, 20, 40]",0.0005,0.001,0.001,5
3549,-0.0005300000000004295,0.5,1,0,7,8,6,2,10,15,5,2,0.1,"[0, 20, 40]",0.0005,0.001,0.0015,1
3550,-0.005680000000001436,0.3333333333333333,3,0,21,24,19,5,10,15,5,2,0.1,"[0, 20, 40]",0.0005,0.001,0.0015,3
3551,-0.006210000000001909,0.35294117647058826,4,0,30,34,29,5,10,15,5,2,0.1,"[0, 20, 40]",0.0005,0.001,0.0015,5
3552,0.0007799999999997148,0.5,0,1,7,8,6,2,10,15,5,2,0.1,"[0, 20, 40]",0.0005,0.0015,0.001,1
3553,0.0010599999999988613,0.4166666666666667,0,4,20,24,19,5,10,15,5,2,0.1,"[0, 20, 40]",0.0005,0.0015,0.001,3
3554,0.0008299999999982441,0.4117647058823529,0,4,30,34,29,5,10,15,5,2,0.1,"[0, 20, 40]",0.0005,0.0015,0.001,5
3555,-0.0015000000000004554,0.375,0,0,8,8,6,2,10,15,5,2,0.1,"[0, 20, 40]",0.0005,0.0015,0.0015,1
3556,-0.007290000000001656,0.25,0,0,24,24,19,5,10,15,5,2,0.1,"[0, 20, 40]",0.0005,0.0015,0.0015,3
3557,-0.007520000000002273,0.29411764705882354,0,0,34,34,29,5,10,15,5,2,0.1,"[0, 20, 40]",0.0005,0.0015,0.0015,5
3558,0.0007799999999997148,0.5,0,1,7,8,6,2,10,15,5,2,0.1,"[0, 20, 40]",0.0005,0.002,0.001,1
3559,0.0010599999999988613,0.4166666666666667,0,4,20,24,19,5,10,15,5,2,0.1,"[0, 20, 40]",0.0005,0.002,0.001,3
3560,0.0008299999999982441,0.4117647058823529,0,4,30,34,29,5,10,15,5,2,0.1,"[0, 20, 40]",0.0005,0.002,0.001,5
3561,-0.0015000000000004554,0.375,0,0,8,8,6,2,10,15,5,2,0.1,"[0, 20, 40]",0.0005,0.002,0.0015,1
3562,-0.007290000000001656,0.25,0,0,24,24,19,5,10,15,5,2,0.1,"[0, 20, 40]",0.0005,0.002,0.0015,3
3563,-0.007520000000002273,0.29411764705882354,0,0,34,34,29,5,10,15,5,2,0.1,"[0, 20, 40]",0.0005,0.002,0.0015,5
3564,0.0029799999999998907,0.5555555555555556,3,2,4,9,9,0,10,15,5,2,0.2,"[0, 20, 40]",0.0003,0.001,0.001,1
3565,0.0001799999999991793,0.35,3,3,14,20,17,3,10,15,5,2,0.2,"[0, 20, 40]",0.0003,0.001,0.001,3
3566,-0.00024000000000092968,0.3076923076923077,3,4,19,26,22,4,10,15,5,2,0.2,"[0, 20, 40]",0.0003,0.001,0.001,5
3567,0.003979999999999891,0.5555555555555556,3,2,4,9,9,0,10,15,5,2,0.2,"[0, 20, 40]",0.0003,0.001,0.0015,1
3568,-0.0006000000000008239,0.3,3,2,15,20,17,3,10,15,5,2,0.2,"[0, 20, 40]",0.0003,0.001,0.0015,3
3569,-0.0010200000000009338,0.2692307692307692,4,2,20,26,22,4,10,15,5,2,0.2,"[0, 20, 40]",0.0003,0.001,0.0015,5
3570,0.001189999999999824,0.4444444444444444,0,2,7,9,9,0,10,15,5,2,0.2,"[0, 20, 40]",0.0003,0.0015,0.001,1
3571,-0.0016100000000008872,0.3,0,3,17,20,17,3,10,15,5,2,0.2,"[0, 20, 40]",0.0003,0.0015,0.001,3
3572,-0.0020300000000009967,0.2692307692307692,0,4,22,26,22,4,10,15,5,2,0.2,"[0, 20, 40]",0.0003,0.0015,0.001,5
3573,0.0021899999999998236,0.4444444444444444,0,2,7,9,9,0,10,15,5,2,0.2,"[0, 20, 40]",0.0003,0.0015,0.0015,1
3574,-0.002390000000000891,0.25,0,2,18,20,17,3,10,15,5,2,0.2,"[0, 20, 40]",0.0003,0.0015,0.0015,3
3575,-0.0027100000000011217,0.23076923076923078,0,2,24,26,22,4,10,15,5,2,0.2,"[0, 20, 40]",0.0003,0.0015,0.0015,5
3576,0.001189999999999824,0.4444444444444444,0,2,7,9,9,0,10,15,5,2,0.2,"[0, 20, 40]",0.0003,0.002,0.001,1
3577,-0.0016100000000008872,0.3,0,3,17,20,17,3,10,15,5,2,0.2,"[0, 20, 40]",0.0003,0.002,0.001,3
3578,-0.0020300000000009967,0.2692307692307692,0,4,22,26,22,4,10,15,5,2,0.2,"[0, 20, 40]",0.0003,0.002,0.001,5
3579,0.0021899999999998236,0.4444444444444444,0,2,7,9,9,0,10,15,5,2,0.2,"[0, 20, 40]",0.0003,0.002,0.0015,1
3580,-0.002390000000000891,0.25,0,2,18,20,17,3,10,15,5,2,0.2,"[0, 20, 40]",0.0003,0.002,0.0015,3
3581,-0.0027100000000011217,0.23076923076923078,0,2,24,26,22,4,10,15,5,2,0.2,"[0, 20, 40]",0.0003,0.002,0.0015,5
3582,0.0005699999999997595,0.5,0,1,3,4,4,0,10,15,5,2,0.2,"[0, 20, 40]",0.0005,0.001,0.001,1
3583,0.0013199999999993642,0.46153846153846156,2,3,8,13,12,1,10,15,5,2,0.2,"[0, 20, 40]",0.0005,0.001,0.001,3
3584,0.0015499999999990944,0.4444444444444444,3,3,12,18,17,1,10,15,5,2,0.2,"[0, 20, 40]",0.0005,0.001,0.001,5
3585,-0.0017100000000004108,0.25,0,0,4,4,4,0,10,15,5,2,0.2,"[0, 20, 40]",0.0005,0.001,0.0015,1
3586,-0.005020000000000978,0.23076923076923078,2,0,11,13,12,1,10,15,5,2,0.2,"[0, 20, 40]",0.0005,0.001,0.0015,3
3587,-0.004790000000001247,0.2777777777777778,3,0,15,18,17,1,10,15,5,2,0.2,"[0, 20, 40]",0.0005,0.001,0.0015,5
3588,0.0005699999999997595,0.5,0,1,3,4,4,0,10,15,5,2,0.2,"[0, 20, 40]",0.0005,0.0015,0.001,1
3589,0.0006799999999991698,0.38461538461538464,0,3,10,13,12,1,10,15,5,2,0.2,"[0, 20, 40]",0.0005,0.0015,0.001,3
3590,0.0012099999999987563,0.3888888888888889,0,3,15,18,17,1,10,15,5,2,0.2,"[0, 20, 40]",0.0005,0.0015,0.001,5
3591,-0.0017100000000004108,0.25,0,0,4,4,4,0,10,15,5,2,0.2,"[0, 20, 40]",0.0005,0.0015,0.0015,1
3592,-0.005660000000001172,0.15384615384615385,0,0,13,13,12,1,10,15,5,2,0.2,"[0, 20, 40]",0.0005,0.0015,0.0015,3
3593,-0.005130000000001585,0.2222222222222222,0,0,18,18,17,1,10,15,5,2,0.2,"[0, 20, 40]",0.0005,0.0015,0.0015,5
3594,0.0005699999999997595,0.5,0,1,3,4,4,0,10,15,5,2,0.2,"[0, 20, 40]",0.0005,0.002,0.001,1
3595,0.0006799999999991698,0.38461538461538464,0,3,10,13,12,1,10,15,5,2,0.2,"[0, 20, 40]",0.0005,0.002,0.001,3
3596,0.0012099999999987563,0.3888888888888889,0,3,15,18,17,1,10,15,5,2,0.2,"[0, 20, 40]",0.0005,0.002,0.001,5
3597,-0.0017100000000004108,0.25,0,0,4,4,4,0,10,15,5,2,0.2,"[0, 20, 40]",0.0005,0.002,0.0015,1
3598,-0.005660000000001172,0.15384615384615385,0,0,13,13,12,1,10,15,5,2,0.2,"[0, 20, 40]",0.0005,0.002,0.0015,3
3599,-0.005130000000001585,0.2222222222222222,0,0,18,18,17,1,10,15,5,2,0.2,"[0, 20, 40]",0.0005,0.002,0.0015,5
3600,0.007889999999998705,0.5161290322580645,8,5,18,31,17,14,10,15,10,1,0.1,"[0, 20, 40]",0.0003,0.001,0.001,1
3601,0.007369999999998474,0.4444444444444444,14,10,39,63,36,27,10,15,10,1,0.1,"[0, 20, 40]",0.0003,0.001,0.001,3
3602,0.011839999999998081,0.46835443037974683,16,14,49,79,50,29,10,15,10,1,0.1,"[0, 20, 40]",0.0003,0.001,0.001,5
3603,0.006369999999998686,0.45161290322580644,8,3,20,31,17,14,10,15,10,1,0.1,"[0, 20, 40]",0.0003,0.001,0.0015,1
3604,0.0039399999999983155,0.38095238095238093,14,6,43,63,36,27,10,15,10,1,0.1,"[0, 20, 40]",0.0003,0.001,0.0015,3
3605,0.0055099999999978656,0.3924050632911392,17,7,55,79,50,29,10,15,10,1,0.1,"[0, 20, 40]",0.0003,0.001,0.0015,5
3606,0.00948999999999875,0.5161290322580645,4,7,20,31,17,14,10,15,10,1,0.1,"[0, 20, 40]",0.0003,0.0015,0.001,1
3607,0.008409999999998183,0.4444444444444444,4,12,47,63,36,27,10,15,10,1,0.1,"[0, 20, 40]",0.0003,0.0015,0.001,3
3608,0.0126999999999975,0.46835443037974683,4,16,59,79,50,29,10,15,10,1,0.1,"[0, 20, 40]",0.0003,0.0015,0.001,5
3609,0.007789999999998601,0.41935483870967744,5,3,23,31,17,14,10,15,10,1,0.1,"[0, 20, 40]",0.0003,0.0015,0.0015,1
3610,0.004799999999997904,0.36507936507936506,5,6,52,63,36,27,10,15,10,1,0.1,"[0, 20, 40]",0.0003,0.0015,0.0015,3
3611,0.006449999999996981,0.379746835443038,5,7,67,79,50,29,10,15,10,1,0.1,"[0, 20, 40]",0.0003,0.0015,0.0015,5
3612,0.009159999999998591,0.5161290322580645,2,7,22,31,17,14,10,15,10,1,0.1,"[0, 20, 40]",0.0003,0.002,0.001,1
3613,0.008079999999998023,0.4444444444444444,2,12,49,63,36,27,10,15,10,1,0.1,"[0, 20, 40]",0.0003,0.002,0.001,3
3614,0.01236999999999734,0.46835443037974683,2,16,61,79,50,29,10,15,10,1,0.1,"[0, 20, 40]",0.0003,0.002,0.001,5
3615,0.00778999999999844,0.41935483870967744,2,3,26,31,17,14,10,15,10,1,0.1,"[0, 20, 40]",0.0003,0.002,0.0015,1
3616,0.004799999999997739,0.36507936507936506,2,6,55,63,36,27,10,15,10,1,0.1,"[0, 20, 40]",0.0003,0.002,0.0015,3
3617,0.006449999999996817,0.379746835443038,2,7,70,79,50,29,10,15,10,1,0.1,"[0, 20, 40]",0.0003,0.002,0.0015,5
3618,0.004359999999999872,0.8571428571428571,3,2,2,7,4,3,10,15,10,1,0.1,"[0, 20, 40]",0.0005,0.001,0.001,1
3619,0.008899999999999703,0.6206896551724138,9,7,13,29,18,11,10,15,10,1,0.1,"[0, 20, 40]",0.0005,0.001,0.001,3
3620,0.012309999999998858,0.6046511627906976,13,9,21,43,31,12,10,15,10,1,0.1,"[0, 20, 40]",0.0005,0.001,0.001,5
3621,0.003979999999999992,0.7142857142857143,3,1,3,7,4,3,10,15,10,1,0.1,"[0, 20, 40]",0.0005,0.001,0.0015,1
3622,0.006809999999999666,0.5172413793103449,9,4,16,29,18,11,10,15,10,1,0.1,"[0, 20, 40]",0.0005,0.001,0.0015,3
3623,0.009279999999998597,0.5116279069767442,13,5,25,43,31,12,10,15,10,1,0.1,"[0, 20, 40]",0.0005,0.001,0.0015,5
3624,0.003129999999999642,0.5714285714285714,1,2,4,7,4,3,10,15,10,1,0.1,"[0, 20, 40]",0.0005,0.0015,0.001,1
3625,0.009369999999999342,0.5517241379310345,4,7,18,29,18,11,10,15,10,1,0.1,"[0, 20, 40]",0.0005,0.0015,0.001,3
3626,0.014119999999998054,0.5581395348837209,6,9,28,43,31,12,10,15,10,1,0.1,"[0, 20, 40]",0.0005,0.0015,0.001,5
3627,0.002749999999999762,0.42857142857142855,1,1,5,7,4,3,10,15,10,1,0.1,"[0, 20, 40]",0.0005,0.0015,0.0015,1
3628,0.007279999999999305,0.4482758620689655,4,4,21,29,18,11,10,15,10,1,0.1,"[0, 20, 40]",0.0005,0.0015,0.0015,3
3629,0.0110899999999978,0.46511627906976744,6,5,32,43,31,12,10,15,10,1,0.1,"[0, 20, 40]",0.0005,0.0015,0.0015,5
3630,0.003629999999999642,0.5714285714285714,1,2,4,7,4,3,10,15,10,1,0.1,"[0, 20, 40]",0.0005,0.002,0.001,1
3631,0.009689999999999217,0.5172413793103449,3,7,19,29,18,11,10,15,10,1,0.1,"[0, 20, 40]",0.0005,0.002,0.001,3
3632,0.014479999999997863,0.5348837209302325,4,9,30,43,31,12,10,15,10,1,0.1,"[0, 20, 40]",0.0005,0.002,0.001,5
3633,0.003249999999999762,0.42857142857142855,1,1,5,7,4,3,10,15,10,1,0.1,"[0, 20, 40]",0.0005,0.002,0.0015,1
3634,0.007599999999999181,0.41379310344827586,3,4,22,29,18,11,10,15,10,1,0.1,"[0, 20, 40]",0.0005,0.002,0.0015,3
3635,0.011449999999997604,0.4418604651162791,4,5,34,43,31,12,10,15,10,1,0.1,"[0, 20, 40]",0.0005,0.002,0.0015,5
3636,0.0059599999999996305,0.6666666666666666,6,2,7,15,12,3,10,15,10,1,0.2,"[0, 20, 40]",0.0003,0.001,0.001,1
3637,0.006209999999999536,0.5357142857142857,8,5,15,28,21,7,10,15,10,1,0.2,"[0, 20, 40]",0.0003,0.001,0.001,3
3638,0.011309999999999232,0.6111111111111112,9,8,19,36,28,8,10,15,10,1,0.2,"[0, 20, 40]",0.0003,0.001,0.001,5
3639,0.0069599999999996305,0.6666666666666666,6,2,7,15,12,3,10,15,10,1,0.2,"[0, 20, 40]",0.0003,0.001,0.0015,1
3640,0.006049999999999485,0.5,8,4,16,28,21,7,10,15,10,1,0.2,"[0, 20, 40]",0.0003,0.001,0.0015,3
3641,0.00824999999999912,0.5277777777777778,9,5,22,36,28,8,10,15,10,1,0.2,"[0, 20, 40]",0.0003,0.001,0.0015,5
3642,0.007059999999999676,0.6666666666666666,3,3,9,15,12,3,10,15,10,1,0.2,"[0, 20, 40]",0.0003,0.0015,0.001,1
3643,0.0067899999999995065,0.5357142857142857,3,6,19,28,21,7,10,15,10,1,0.2,"[0, 20, 40]",0.0003,0.0015,0.001,3
3644,0.011669999999998985,0.6111111111111112,3,9,24,36,28,8,10,15,10,1,0.2,"[0, 20, 40]",0.0003,0.0015,0.001,5
3645,0.007379999999999552,0.6,3,2,10,15,12,3,10,15,10,1,0.2,"[0, 20, 40]",0.0003,0.0015,0.0015,1
3646,0.005949999999999331,0.4642857142857143,3,4,21,28,21,7,10,15,10,1,0.2,"[0, 20, 40]",0.0003,0.0015,0.0015,3
3647,0.007929999999998747,0.5,3,5,28,36,28,8,10,15,10,1,0.2,"[0, 20, 40]",0.0003,0.0015,0.0015,5
3648,0.006229999999999514,0.6666666666666666,1,3,11,15,12,3,10,15,10,1,0.2,"[0, 20, 40]",0.0003,0.002,0.001,1
3649,0.0059599999999993426,0.5357142857142857,1,6,21,28,21,7,10,15,10,1,0.2,"[0, 20, 40]",0.0003,0.002,0.001,3
3650,0.010839999999998825,0.6111111111111112,1,9,26,36,28,8,10,15,10,1,0.2,"[0, 20, 40]",0.0003,0.002,0.001,5
3651,0.0065499999999993905,0.6,1,2,12,15,12,3,10,15,10,1,0.2,"[0, 20, 40]",0.0003,0.002,0.0015,1
3652,0.005119999999999168,0.4642857142857143,1,4,23,28,21,7,10,15,10,1,0.2,"[0, 20, 40]",0.0003,0.002,0.0015,3
3653,0.007099999999998584,0.5,1,5,30,36,28,8,10,15,10,1,0.2,"[0, 20, 40]",0.0003,0.002,0.0015,5
3654,0.002759999999999872,0.8,2,1,2,5,4,1,10,15,10,1,0.2,"[0, 20, 40]",0.0005,0.001,0.001,1
3655,0.004739999999999918,0.6470588235294118,5,4,8,17,14,3,10,15,10,1,0.2,"[0, 20, 40]",0.0005,0.001,0.001,3
3656,0.006709999999999479,0.6521739130434783,6,6,11,23,20,3,10,15,10,1,0.2,"[0, 20, 40]",0.0005,0.001,0.001,5
3657,0.0032599999999998715,0.8,2,1,2,5,4,1,10,15,10,1,0.2,"[0, 20, 40]",0.0005,0.001,0.0015,1
3658,0.0042399999999998056,0.5882352941176471,5,3,9,17,14,3,10,15,10,1,0.2,"[0, 20, 40]",0.0005,0.001,0.0015,3
3659,0.005269999999999146,0.5652173913043478,6,4,13,23,20,3,10,15,10,1,0.2,"[0, 20, 40]",0.0005,0.001,0.0015,5
3660,0.002639999999999697,0.6,1,1,3,5,4,1,10,15,10,1,0.2,"[0, 20, 40]",0.0005,0.0015,0.001,1
3661,0.005079999999999704,0.5882352941176471,2,4,11,17,14,3,10,15,10,1,0.2,"[0, 20, 40]",0.0005,0.0015,0.001,3
3662,0.006929999999999036,0.6086956521739131,2,6,15,23,20,3,10,15,10,1,0.2,"[0, 20, 40]",0.0005,0.0015,0.001,5
3663,0.0031399999999996964,0.6,1,1,3,5,4,1,10,15,10,1,0.2,"[0, 20, 40]",0.0005,0.0015,0.0015,1
3664,0.004579999999999592,0.5294117647058824,2,3,12,17,14,3,10,15,10,1,0.2,"[0, 20, 40]",0.0005,0.0015,0.0015,3
3665,0.005489999999998703,0.5217391304347826,2,4,17,23,20,3,10,15,10,1,0.2,"[0, 20, 40]",0.0005,0.0015,0.0015,5
3666,0.003139999999999697,0.6,1,1,3,5,4,1,10,15,10,1,0.2,"[0, 20, 40]",0.0005,0.002,0.001,1
3667,0.00439999999999958,0.5294117647058824,1,4,12,17,14,3,10,15,10,1,0.2,"[0, 20, 40]",0.0005,0.002,0.001,3
3668,0.006249999999998909,0.5652173913043478,1,6,16,23,20,3,10,15,10,1,0.2,"[0, 20, 40]",0.0005,0.002,0.001,5
3669,0.0036399999999996964,0.6,1,1,3,5,4,1,10,15,10,1,0.2,"[0, 20, 40]",0.0005,0.002,0.0015,1
3670,0.003899999999999467,0.47058823529411764,1,3,13,17,14,3,10,15,10,1,0.2,"[0, 20, 40]",0.0005,0.002,0.0015,3
3671,0.004809999999998579,0.4782608695652174,1,4,18,23,20,3,10,15,10,1,0.2,"[0, 20, 40]",0.0005,0.002,0.0015,5
3672,0.002449999999998929,0.38095238095238093,4,2,15,21,14,7,10,15,10,2,0.1,"[0, 20, 40]",0.0003,0.001,0.001,1
3673,0.00558999999999838,0.425531914893617,10,7,30,47,32,15,10,15,10,2,0.1,"[0, 20, 40]",0.0003,0.001,0.001,3
3674,0.010839999999998063,0.48333333333333334,12,11,37,60,44,16,10,15,10,2,0.1,"[0, 20, 40]",0.0003,0.001,0.001,5
3675,0.0034499999999989283,0.38095238095238093,4,2,15,21,14,7,10,15,10,2,0.1,"[0, 20, 40]",0.0003,0.001,0.0015,1
3676,0.00642999999999833,0.40425531914893614,10,6,31,47,32,15,10,15,10,2,0.1,"[0, 20, 40]",0.0003,0.001,0.0015,3
3677,0.008779999999997947,0.43333333333333335,13,7,40,60,44,16,10,15,10,2,0.1,"[0, 20, 40]",0.0003,0.001,0.0015,5
3678,0.0028999999999989906,0.38095238095238093,2,3,16,21,14,7,10,15,10,2,0.1,"[0, 20, 40]",0.0003,0.0015,0.001,1
3679,0.005979999999998274,0.425531914893617,2,8,37,47,32,15,10,15,10,2,0.1,"[0, 20, 40]",0.0003,0.0015,0.001,3
3680,0.01104999999999767,0.48333333333333334,2,12,46,60,44,16,10,15,10,2,0.1,"[0, 20, 40]",0.0003,0.0015,0.001,5
3681,0.0032199999999988657,0.3333333333333333,2,2,17,21,14,7,10,15,10,2,0.1,"[0, 20, 40]",0.0003,0.0015,0.0015,1
3682,0.006139999999998102,0.3829787234042553,2,6,39,47,32,15,10,15,10,2,0.1,"[0, 20, 40]",0.0003,0.0015,0.0015,3
3683,0.008569999999997243,0.4166666666666667,2,7,51,60,44,16,10,15,10,2,0.1,"[0, 20, 40]",0.0003,0.0015,0.0015,5
3684,0.0033399999999990985,0.38095238095238093,1,3,17,21,14,7,10,15,10,2,0.1,"[0, 20, 40]",0.0003,0.002,0.001,1
3685,0.006419999999998383,0.425531914893617,1,8,38,47,32,15,10,15,10,2,0.1,"[0, 20, 40]",0.0003,0.002,0.001,3
3686,0.011489999999997776,0.48333333333333334,1,12,47,60,44,16,10,15,10,2,0.1,"[0, 20, 40]",0.0003,0.002,0.001,5
3687,0.0036599999999989735,0.3333333333333333,1,2,18,21,14,7,10,15,10,2,0.1,"[0, 20, 40]",0.0003,0.002,0.0015,1
3688,0.0065799999999982105,0.3829787234042553,1,6,40,47,32,15,10,15,10,2,0.1,"[0, 20, 40]",0.0003,0.002,0.0015,3
3689,0.009009999999997352,0.4166666666666667,1,7,52,60,44,16,10,15,10,2,0.1,"[0, 20, 40]",0.0003,0.002,0.0015,5
3690,0.0027299999999999412,0.625,3,1,4,8,6,2,10,15,10,2,0.1,"[0, 20, 40]",0.0005,0.001,0.001,1
3691,0.007859999999999775,0.625,7,6,11,24,19,5,10,15,10,2,0.1,"[0, 20, 40]",0.0005,0.001,0.001,3
3692,0.012219999999999223,0.6285714285714286,11,8,16,35,30,5,10,15,10,2,0.1,"[0, 20, 40]",0.0005,0.001,0.001,5
3693,0.0032299999999999413,0.625,3,1,4,8,6,2,10,15,10,2,0.1,"[0, 20, 40]",0.0005,0.001,0.0015,1
3694,0.008359999999999658,0.5833333333333334,7,5,12,24,19,5,10,15,10,2,0.1,"[0, 20, 40]",0.0005,0.001,0.0015,3
3695,0.011779999999998892,0.5714285714285714,11,6,18,35,30,5,10,15,10,2,0.1,"[0, 20, 40]",0.0005,0.001,0.0015,5
3696,0.0014999999999997119,0.375,1,1,6,8,6,2,10,15,10,2,0.1,"[0, 20, 40]",0.0005,0.0015,0.001,1
3697,0.007329999999999413,0.5416666666666666,2,6,16,24,19,5,10,15,10,2,0.1,"[0, 20, 40]",0.0005,0.0015,0.001,3
3698,0.013029999999998423,0.5714285714285714,4,8,23,35,30,5,10,15,10,2,0.1,"[0, 20, 40]",0.0005,0.0015,0.001,5
3699,0.0019999999999997116,0.375,1,1,6,8,6,2,10,15,10,2,0.1,"[0, 20, 40]",0.0005,0.0015,0.0015,1
3700,0.007829999999999298,0.5,2,5,17,24,19,5,10,15,10,2,0.1,"[0, 20, 40]",0.0005,0.0015,0.0015,3
3701,0.012589999999998094,0.5142857142857142,4,6,25,35,30,5,10,15,10,2,0.1,"[0, 20, 40]",0.0005,0.0015,0.0015,5
3702,0.001999999999999712,0.375,1,1,6,8,6,2,10,15,10,2,0.1,"[0, 20, 40]",0.0005,0.002,0.001,1
3703,0.008329999999999414,0.5416666666666666,2,6,16,24,19,5,10,15,10,2,0.1,"[0, 20, 40]",0.0005,0.002,0.001,3
3704,0.014069999999998351,0.5714285714285714,3,8,24,35,30,5,10,15,10,2,0.1,"[0, 20, 40]",0.0005,0.002,0.001,5
3705,0.0024999999999997117,0.375,1,1,6,8,6,2,10,15,10,2,0.1,"[0, 20, 40]",0.0005,0.002,0.0015,1
3706,0.008829999999999298,0.5,2,5,17,24,19,5,10,15,10,2,0.1,"[0, 20, 40]",0.0005,0.002,0.0015,3
3707,0.01362999999999802,0.5142857142857142,3,6,26,35,30,5,10,15,10,2,0.1,"[0, 20, 40]",0.0005,0.002,0.0015,5
3708,0.003269999999999792,0.6666666666666666,3,2,4,9,9,0,10,15,10,2,0.2,"[0, 20, 40]",0.0003,0.001,0.001,1
3709,0.0038299999999995503,0.55,5,5,10,20,17,3,10,15,10,2,0.2,"[0, 20, 40]",0.0003,0.001,0.001,3
3710,0.008789999999999246,0.6666666666666666,5,9,13,27,23,4,10,15,10,2,0.2,"[0, 20, 40]",0.0003,0.001,0.001,5
3711,0.004269999999999792,0.6666666666666666,3,2,4,9,9,0,10,15,10,2,0.2,"[0, 20, 40]",0.0003,0.001,0.0015,1
3712,0.0036699999999995,0.5,5,4,11,20,17,3,10,15,10,2,0.2,"[0, 20, 40]",0.0003,0.001,0.0015,3
3713,0.00572999999999913,0.5555555555555556,6,5,16,27,23,4,10,15,10,2,0.2,"[0, 20, 40]",0.0003,0.001,0.0015,5
3714,0.0032199999999998536,0.6666666666666666,1,3,5,9,9,0,10,15,10,2,0.2,"[0, 20, 40]",0.0003,0.0015,0.001,1
3715,0.003909999999999577,0.55,1,6,13,20,17,3,10,15,10,2,0.2,"[0, 20, 40]",0.0003,0.0015,0.001,3
3716,0.008869999999999274,0.6666666666666666,1,10,16,27,23,4,10,15,10,2,0.2,"[0, 20, 40]",0.0003,0.0015,0.001,5
3717,0.003539999999999729,0.5555555555555556,1,2,6,9,9,0,10,15,10,2,0.2,"[0, 20, 40]",0.0003,0.0015,0.0015,1
3718,0.0030699999999994026,0.45,1,4,15,20,17,3,10,15,10,2,0.2,"[0, 20, 40]",0.0003,0.0015,0.0015,3
3719,0.005389999999998849,0.5185185185185185,1,5,21,27,23,4,10,15,10,2,0.2,"[0, 20, 40]",0.0003,0.0015,0.0015,5
3720,0.0031599999999999615,0.6666666666666666,0,3,6,9,9,0,10,15,10,2,0.2,"[0, 20, 40]",0.0003,0.002,0.001,1
3721,0.0038499999999996844,0.55,0,6,14,20,17,3,10,15,10,2,0.2,"[0, 20, 40]",0.0003,0.002,0.001,3
3722,0.008809999999999383,0.6666666666666666,0,10,17,27,23,4,10,15,10,2,0.2,"[0, 20, 40]",0.0003,0.002,0.001,5
3723,0.0034799999999998365,0.5555555555555556,0,2,7,9,9,0,10,15,10,2,0.2,"[0, 20, 40]",0.0003,0.002,0.0015,1
3724,0.0030099999999995105,0.45,0,4,16,20,17,3,10,15,10,2,0.2,"[0, 20, 40]",0.0003,0.002,0.0015,3
3725,0.005329999999998957,0.5185185185185185,0,5,22,27,23,4,10,15,10,2,0.2,"[0, 20, 40]",0.0003,0.002,0.0015,5
3726,0.0006499999999998396,0.5,0,1,3,4,4,0,10,15,10,2,0.2,"[0, 20, 40]",0.0005,0.001,0.001,1
3727,0.0021299999999998954,0.5384615384615384,2,4,7,13,12,1,10,15,10,2,0.2,"[0, 20, 40]",0.0005,0.001,0.001,3
3728,0.004579999999999602,0.5789473684210527,4,6,9,19,18,1,10,15,10,2,0.2,"[0, 20, 40]",0.0005,0.001,0.001,5
3729,0.001149999999999839,0.5,0,1,3,4,4,0,10,15,10,2,0.2,"[0, 20, 40]",0.0005,0.001,0.0015,1
3730,0.0016299999999997833,0.46153846153846156,2,3,8,13,12,1,10,15,10,2,0.2,"[0, 20, 40]",0.0005,0.001,0.0015,3
3731,0.00313999999999927,0.47368421052631576,4,4,11,19,18,1,10,15,10,2,0.2,"[0, 20, 40]",0.0005,0.001,0.0015,5
3732,0.0006499999999998396,0.5,0,1,3,4,4,0,10,15,10,2,0.2,"[0, 20, 40]",0.0005,0.0015,0.001,1
3733,0.002589999999999745,0.5384615384615384,1,4,8,13,12,1,10,15,10,2,0.2,"[0, 20, 40]",0.0005,0.0015,0.001,3
3734,0.0053799999999990175,0.5789473684210527,1,6,12,19,18,1,10,15,10,2,0.2,"[0, 20, 40]",0.0005,0.0015,0.001,5
3735,0.001149999999999839,0.5,0,1,3,4,4,0,10,15,10,2,0.2,"[0, 20, 40]",0.0005,0.0015,0.0015,1
3736,0.002089999999999633,0.46153846153846156,1,3,9,13,12,1,10,15,10,2,0.2,"[0, 20, 40]",0.0005,0.0015,0.0015,3
3737,0.003939999999998684,0.47368421052631576,1,4,14,19,18,1,10,15,10,2,0.2,"[0, 20, 40]",0.0005,0.0015,0.0015,5
3738,0.0006499999999998396,0.5,0,1,3,4,4,0,10,15,10,2,0.2,"[0, 20, 40]",0.0005,0.002,0.001,1
3739,0.003089999999999745,0.5384615384615384,1,4,8,13,12,1,10,15,10,2,0.2,"[0, 20, 40]",0.0005,0.002,0.001,3
3740,0.005879999999999018,0.5789473684210527,1,6,12,19,18,1,10,15,10,2,0.2,"[0, 20, 40]",0.0005,0.002,0.001,5
3741,0.001149999999999839,0.5,0,1,3,4,4,0,10,15,10,2,0.2,"[0, 20, 40]",0.0005,0.002,0.0015,1
3742,0.002589999999999633,0.46153846153846156,1,3,9,13,12,1,10,15,10,2,0.2,"[0, 20, 40]",0.0005,0.002,0.0015,3
3743,0.004439999999998685,0.47368421052631576,1,4,14,19,18,1,10,15,10,2,0.2,"[0, 20, 40]",0.0005,0.002,0.0015,5
3744,0.008829999999998912,0.6206896551724138,8,7,14,29,15,14,10,15,15,1,0.1,"[0, 20, 40]",0.0003,0.001,0.001,1
3745,0.018099999999998208,0.6166666666666667,15,17,28,60,33,27,10,15,15,1,0.1,"[0, 20, 40]",0.0003,0.001,0.001,3
3746,0.02392999999999762,0.618421052631579,19,21,36,76,47,29,10,15,15,1,0.1,"[0, 20, 40]",0.0003,0.001,0.001,5
3747,0.0023399999999986912,0.4827586206896552,9,2,18,29,15,14,10,15,15,1,0.1,"[0, 20, 40]",0.0003,0.001,0.0015,1
3748,0.008189999999997684,0.48333333333333334,16,8,36,60,33,27,10,15,15,1,0.1,"[0, 20, 40]",0.0003,0.001,0.0015,3
3749,0.012859999999997276,0.5,21,10,45,76,47,29,10,15,15,1,0.1,"[0, 20, 40]",0.0003,0.001,0.0015,5
3750,0.01130999999999889,0.6206896551724138,5,9,15,29,15,14,10,15,15,1,0.1,"[0, 20, 40]",0.0003,0.0015,0.001,1
3751,0.020979999999997865,0.6,8,19,33,60,33,27,10,15,15,1,0.1,"[0, 20, 40]",0.0003,0.0015,0.001,3
3752,0.02688999999999715,0.6052631578947368,8,23,45,76,47,29,10,15,15,1,0.1,"[0, 20, 40]",0.0003,0.0015,0.001,5
3753,0.005819999999998564,0.4827586206896552,7,2,20,29,15,14,10,15,15,1,0.1,"[0, 20, 40]",0.0003,0.0015,0.0015,1
3754,0.012069999999997229,0.4666666666666667,10,8,42,60,33,27,10,15,15,1,0.1,"[0, 20, 40]",0.0003,0.0015,0.0015,3
3755,0.017319999999996692,0.4868421052631579,11,10,55,76,47,29,10,15,15,1,0.1,"[0, 20, 40]",0.0003,0.0015,0.0015,5
3756,0.011339999999998924,0.5862068965517241,3,9,17,29,15,14,10,15,15,1,0.1,"[0, 20, 40]",0.0003,0.002,0.001,1
3757,0.021899999999997893,0.5833333333333334,5,19,36,60,33,27,10,15,15,1,0.1,"[0, 20, 40]",0.0003,0.002,0.001,3
3758,0.027809999999997188,0.5921052631578947,5,23,48,76,47,29,10,15,15,1,0.1,"[0, 20, 40]",0.0003,0.002,0.001,5
3759,0.006269999999998796,0.4482758620689655,3,2,24,29,15,14,10,15,15,1,0.1,"[0, 20, 40]",0.0003,0.002,0.0015,1
3760,0.013409999999997462,0.45,5,8,47,60,33,27,10,15,15,1,0.1,"[0, 20, 40]",0.0003,0.002,0.0015,3
3761,0.019159999999996936,0.47368421052631576,6,10,60,76,47,29,10,15,15,1,0.1,"[0, 20, 40]",0.0003,0.002,0.0015,5
3762,0.003949999999999873,0.8333333333333334,4,1,1,6,3,3,10,15,15,1,0.1,"[0, 20, 40]",0.0005,0.001,0.001,1
3763,0.01458999999999936,0.75,11,10,7,28,17,11,10,15,15,1,0.1,"[0, 20, 40]",0.0005,0.001,0.001,3
3764,0.017509999999998856,0.6904761904761905,15,12,15,42,30,12,10,15,15,1,0.1,"[0, 20, 40]",0.0005,0.001,0.001,5
3765,0.003949999999999873,0.8333333333333334,5,0,1,6,3,3,10,15,15,1,0.1,"[0, 20, 40]",0.0005,0.001,0.0015,1
3766,0.00988999999999927,0.6071428571428571,12,5,11,28,17,11,10,15,15,1,0.1,"[0, 20, 40]",0.0005,0.001,0.0015,3
3767,0.013809999999998764,0.5952380952380952,16,7,19,42,30,12,10,15,15,1,0.1,"[0, 20, 40]",0.0005,0.001,0.0015,5
3768,0.0019899999999996353,0.5,1,1,4,6,3,3,10,15,15,1,0.1,"[0, 20, 40]",0.0005,0.0015,0.001,1
3769,0.014519999999998956,0.6785714285714286,5,10,13,28,17,11,10,15,15,1,0.1,"[0, 20, 40]",0.0005,0.0015,0.001,3
3770,0.01909999999999828,0.6428571428571429,8,12,22,42,30,12,10,15,15,1,0.1,"[0, 20, 40]",0.0005,0.0015,0.001,5
3771,0.0024899999999996353,0.5,2,0,4,6,3,3,10,15,15,1,0.1,"[0, 20, 40]",0.0005,0.0015,0.0015,1
3772,0.010319999999998863,0.5357142857142857,6,5,17,28,17,11,10,15,15,1,0.1,"[0, 20, 40]",0.0005,0.0015,0.0015,3
3773,0.015899999999998186,0.5476190476190477,9,7,26,42,30,12,10,15,15,1,0.1,"[0, 20, 40]",0.0005,0.0015,0.0015,5
3774,0.0024899999999996353,0.5,1,1,4,6,3,3,10,15,15,1,0.1,"[0, 20, 40]",0.0005,0.002,0.001,1
3775,0.01528999999999895,0.6785714285714286,3,10,15,28,17,11,10,15,15,1,0.1,"[0, 20, 40]",0.0005,0.002,0.001,3
3776,0.019529999999998212,0.6190476190476191,5,12,25,42,30,12,10,15,15,1,0.1,"[0, 20, 40]",0.0005,0.002,0.001,5
3777,0.0034899999999996353,0.5,2,0,4,6,3,3,10,15,15,1,0.1,"[0, 20, 40]",0.0005,0.002,0.0015,1
3778,0.01158999999999886,0.5357142857142857,4,5,19,28,17,11,10,15,15,1,0.1,"[0, 20, 40]",0.0005,0.002,0.0015,3
3779,0.01682999999999812,0.5238095238095238,6,7,29,42,30,12,10,15,15,1,0.1,"[0, 20, 40]",0.0005,0.002,0.0015,5
3780,0.004659999999999482,0.6923076923076923,5,2,6,13,10,3,10,15,15,1,0.2,"[0, 20, 40]",0.0003,0.001,0.001,1
3781,0.0062099999999988015,0.5769230769230769,7,5,14,26,19,7,10,15,15,1,0.2,"[0, 20, 40]",0.0003,0.001,0.001,3
3782,0.011489999999998569,0.6470588235294118,10,8,16,34,26,8,10,15,15,1,0.2,"[0, 20, 40]",0.0003,0.001,0.001,5
3783,0.002819999999999586,0.6153846153846154,5,1,7,13,10,3,10,15,15,1,0.2,"[0, 20, 40]",0.0003,0.001,0.0015,1
3784,0.0038599999999986674,0.5,7,3,16,26,19,7,10,15,15,1,0.2,"[0, 20, 40]",0.0003,0.001,0.0015,3
3785,0.007979999999998615,0.5588235294117647,10,5,19,34,26,8,10,15,15,1,0.2,"[0, 20, 40]",0.0003,0.001,0.0015,5
3786,0.006659999999999484,0.6923076923076923,4,3,6,13,10,3,10,15,15,1,0.2,"[0, 20, 40]",0.0003,0.0015,0.001,1
3787,0.008429999999998692,0.5769230769230769,4,6,16,26,19,7,10,15,15,1,0.2,"[0, 20, 40]",0.0003,0.0015,0.001,3
3788,0.013849999999998376,0.6470588235294118,4,9,21,34,26,8,10,15,15,1,0.2,"[0, 20, 40]",0.0003,0.0015,0.001,5
3789,0.004819999999999477,0.6153846153846154,4,1,8,13,10,3,10,15,15,1,0.2,"[0, 20, 40]",0.0003,0.0015,0.0015,1
3790,0.00607999999999845,0.5,4,3,19,26,19,7,10,15,15,1,0.2,"[0, 20, 40]",0.0003,0.0015,0.0015,3
3791,0.010339999999998307,0.5588235294117647,4,5,25,34,26,8,10,15,15,1,0.2,"[0, 20, 40]",0.0003,0.0015,0.0015,5
3792,0.006189999999999515,0.6153846153846154,2,3,8,13,10,3,10,15,15,1,0.2,"[0, 20, 40]",0.0003,0.002,0.001,1
3793,0.007959999999998725,0.5384615384615384,2,6,18,26,19,7,10,15,15,1,0.2,"[0, 20, 40]",0.0003,0.002,0.001,3
3794,0.013379999999998407,0.6176470588235294,2,9,23,34,26,8,10,15,15,1,0.2,"[0, 20, 40]",0.0003,0.002,0.001,5
3795,0.004349999999999507,0.5384615384615384,2,1,10,13,10,3,10,15,15,1,0.2,"[0, 20, 40]",0.0003,0.002,0.0015,1
3796,0.005609999999998482,0.46153846153846156,2,3,21,26,19,7,10,15,15,1,0.2,"[0, 20, 40]",0.0003,0.002,0.0015,3
3797,0.009869999999998344,0.5294117647058824,2,5,27,34,26,8,10,15,15,1,0.2,"[0, 20, 40]",0.0003,0.002,0.0015,5
3798,0.0023499999999998726,0.75,3,0,1,4,3,1,10,15,15,1,0.2,"[0, 20, 40]",0.0005,0.001,0.001,1
3799,0.007559999999999541,0.6875,6,5,5,16,13,3,10,15,15,1,0.2,"[0, 20, 40]",0.0005,0.001,0.001,3
3800,0.008699999999999214,0.6363636363636364,7,7,8,22,19,3,10,15,15,1,0.2,"[0, 20, 40]",0.0005,0.001,0.001,5
3801,0.0023499999999998726,0.75,3,0,1,4,3,1,10,15,15,1,0.2,"[0, 20, 40]",0.0005,0.001,0.0015,1
3802,0.00577999999999937,0.5625,6,3,7,16,13,3,10,15,15,1,0.2,"[0, 20, 40]",0.0005,0.001,0.0015,3
3803,0.00791999999999904,0.5454545454545454,7,5,10,22,19,3,10,15,15,1,0.2,"[0, 20, 40]",0.0005,0.001,0.0015,5
3804,0.001099999999999512,0.5,1,0,3,4,3,1,10,15,15,1,0.2,"[0, 20, 40]",0.0005,0.0015,0.001,1
3805,0.007559999999999151,0.625,3,5,8,16,13,3,10,15,15,1,0.2,"[0, 20, 40]",0.0005,0.0015,0.001,3
3806,0.008859999999998654,0.5909090909090909,3,7,12,22,19,3,10,15,15,1,0.2,"[0, 20, 40]",0.0005,0.0015,0.001,5
3807,0.001099999999999512,0.5,1,0,3,4,3,1,10,15,15,1,0.2,"[0, 20, 40]",0.0005,0.0015,0.0015,1
3808,0.005779999999998979,0.5,3,3,10,16,13,3,10,15,15,1,0.2,"[0, 20, 40]",0.0005,0.0015,0.0015,3
3809,0.008079999999998482,0.5,3,5,14,22,19,3,10,15,15,1,0.2,"[0, 20, 40]",0.0005,0.0015,0.0015,5
3810,0.001599999999999512,0.5,1,0,3,4,3,1,10,15,15,1,0.2,"[0, 20, 40]",0.0005,0.002,0.001,1
3811,0.0073299999999991445,0.625,1,5,10,16,13,3,10,15,15,1,0.2,"[0, 20, 40]",0.0005,0.002,0.001,3
3812,0.008629999999998647,0.5909090909090909,1,7,14,22,19,3,10,15,15,1,0.2,"[0, 20, 40]",0.0005,0.002,0.001,5
3813,0.001599999999999512,0.5,1,0,3,4,3,1,10,15,15,1,0.2,"[0, 20, 40]",0.0005,0.002,0.0015,1
3814,0.005549999999998974,0.5,1,3,12,16,13,3,10,15,15,1,0.2,"[0, 20, 40]",0.0005,0.002,0.0015,3
3815,0.007849999999998476,0.5,1,5,16,22,19,3,10,15,15,1,0.2,"[0, 20, 40]",0.0005,0.002,0.0015,5
3816,1.9999999999152857e-05,0.3684210526315789,4,1,14,19,12,7,10,15,15,2,0.1,"[0, 20, 40]",0.0003,0.001,0.001,1
3817,0.008369999999998561,0.5227272727272727,11,9,24,44,29,15,10,15,15,2,0.1,"[0, 20, 40]",0.0003,0.001,0.001,3
3818,0.01423999999999831,0.5614035087719298,15,13,29,57,41,16,10,15,15,2,0.1,"[0, 20, 40]",0.0003,0.001,0.001,5
3819,0.0005199999999991531,0.3684210526315789,4,1,14,19,12,7,10,15,15,2,0.1,"[0, 20, 40]",0.0003,0.001,0.0015,1
3820,0.008429999999998229,0.4772727272727273,11,7,26,44,29,15,10,15,15,2,0.1,"[0, 20, 40]",0.0003,0.001,0.0015,3
3821,0.013139999999998144,0.5087719298245614,16,9,32,57,41,16,10,15,15,2,0.1,"[0, 20, 40]",0.0003,0.001,0.0015,5
3822,0.0009999999999991335,0.3684210526315789,2,2,15,19,12,7,10,15,15,2,0.1,"[0, 20, 40]",0.0003,0.0015,0.001,1
3823,0.009949999999998202,0.5,5,10,29,44,29,15,10,15,15,2,0.1,"[0, 20, 40]",0.0003,0.0015,0.001,3
3824,0.015899999999997805,0.543859649122807,5,14,38,57,41,16,10,15,15,2,0.1,"[0, 20, 40]",0.0003,0.0015,0.001,5
3825,0.0014999999999990236,0.3684210526315789,2,1,16,19,12,7,10,15,15,2,0.1,"[0, 20, 40]",0.0003,0.0015,0.0015,1
3826,0.010009999999997755,0.45454545454545453,5,7,32,44,29,15,10,15,15,2,0.1,"[0, 20, 40]",0.0003,0.0015,0.0015,3
3827,0.015299999999997533,0.49122807017543857,6,9,42,57,41,16,10,15,15,2,0.1,"[0, 20, 40]",0.0003,0.0015,0.0015,5
3828,0.0019999999999991335,0.3684210526315789,2,2,15,19,12,7,10,15,15,2,0.1,"[0, 20, 40]",0.0003,0.002,0.001,1
3829,0.0118399999999982,0.5,4,10,30,44,29,15,10,15,15,2,0.1,"[0, 20, 40]",0.0003,0.002,0.001,3
3830,0.017789999999997808,0.543859649122807,4,14,39,57,41,16,10,15,15,2,0.1,"[0, 20, 40]",0.0003,0.002,0.001,5
3831,0.0024999999999990234,0.3684210526315789,2,1,16,19,12,7,10,15,15,2,0.1,"[0, 20, 40]",0.0003,0.002,0.0015,1
3832,0.011899999999997756,0.45454545454545453,4,7,33,44,29,15,10,15,15,2,0.1,"[0, 20, 40]",0.0003,0.002,0.0015,3
3833,0.01768999999999754,0.49122807017543857,5,9,43,57,41,16,10,15,15,2,0.1,"[0, 20, 40]",0.0003,0.002,0.0015,5
3834,0.002759999999999938,0.5714285714285714,4,0,3,7,5,2,10,15,15,2,0.1,"[0, 20, 40]",0.0005,0.001,0.001,1
3835,0.011169999999999606,0.6956521739130435,9,7,7,23,18,5,10,15,15,2,0.1,"[0, 20, 40]",0.0005,0.001,0.001,3
3836,0.015769999999999295,0.7058823529411765,13,9,12,34,29,5,10,15,15,2,0.1,"[0, 20, 40]",0.0005,0.001,0.001,5
3837,0.002759999999999938,0.5714285714285714,4,0,3,7,5,2,10,15,15,2,0.1,"[0, 20, 40]",0.0005,0.001,0.0015,1
3838,0.009979999999999415,0.6086956521739131,9,5,9,23,18,5,10,15,15,2,0.1,"[0, 20, 40]",0.0005,0.001,0.0015,3
3839,0.015579999999999103,0.6470588235294118,13,7,14,34,29,5,10,15,15,2,0.1,"[0, 20, 40]",0.0005,0.001,0.0015,5
3840,0.0007999999999997008,0.2857142857142857,1,0,6,7,5,2,10,15,15,2,0.1,"[0, 20, 40]",0.0005,0.0015,0.001,1
3841,0.010099999999999205,0.6086956521739131,3,7,13,23,18,5,10,15,15,2,0.1,"[0, 20, 40]",0.0005,0.0015,0.001,3
3842,0.016359999999998723,0.6470588235294118,6,9,19,34,29,5,10,15,15,2,0.1,"[0, 20, 40]",0.0005,0.0015,0.001,5
3843,0.0007999999999997008,0.2857142857142857,1,0,6,7,5,2,10,15,15,2,0.1,"[0, 20, 40]",0.0005,0.0015,0.0015,1
3844,0.008909999999999014,0.5217391304347826,3,5,15,23,18,5,10,15,15,2,0.1,"[0, 20, 40]",0.0005,0.0015,0.0015,3
3845,0.01616999999999853,0.5882352941176471,6,7,21,34,29,5,10,15,15,2,0.1,"[0, 20, 40]",0.0005,0.0015,0.0015,5
3846,0.0012999999999997007,0.2857142857142857,1,0,6,7,5,2,10,15,15,2,0.1,"[0, 20, 40]",0.0005,0.002,0.001,1
3847,0.010999999999999269,0.6086956521739131,2,7,14,23,18,5,10,15,15,2,0.1,"[0, 20, 40]",0.0005,0.002,0.001,3
3848,0.016919999999998728,0.6176470588235294,4,9,21,34,29,5,10,15,15,2,0.1,"[0, 20, 40]",0.0005,0.002,0.001,5
3849,0.0012999999999997007,0.2857142857142857,1,0,6,7,5,2,10,15,15,2,0.1,"[0, 20, 40]",0.0005,0.002,0.0015,1
3850,0.009809999999999083,0.5217391304347826,2,5,16,23,18,5,10,15,15,2,0.1,"[0, 20, 40]",0.0005,0.002,0.0015,3
3851,0.016729999999998534,0.5588235294117647,4,7,23,34,29,5,10,15,15,2,0.1,"[0, 20, 40]",0.0005,0.002,0.0015,5
3852,0.002139999999999763,0.5714285714285714,2,1,4,7,7,0,10,15,15,2,0.2,"[0, 20, 40]",0.0003,0.001,0.001,1
3853,0.005489999999999369,0.6111111111111112,4,6,8,18,15,3,10,15,15,2,0.2,"[0, 20, 40]",0.0003,0.001,0.001,3
3854,0.010909999999999191,0.72,6,10,9,25,21,4,10,15,15,2,0.2,"[0, 20, 40]",0.0003,0.001,0.001,5
3855,0.0026399999999997623,0.5714285714285714,2,1,4,7,7,0,10,15,15,2,0.2,"[0, 20, 40]",0.0003,0.001,0.0015,1
3856,0.004049999999999037,0.5,4,4,10,18,15,3,10,15,15,2,0.2,"[0, 20, 40]",0.0003,0.001,0.0015,3
3857,0.00830999999999903,0.6,7,6,12,25,21,4,10,15,15,2,0.2,"[0, 20, 40]",0.0003,0.001,0.0015,5
3858,0.0026399999999997628,0.5714285714285714,1,2,4,7,7,0,10,15,15,2,0.2,"[0, 20, 40]",0.0003,0.0015,0.001,1
3859,0.005469999999999237,0.5555555555555556,2,7,9,18,15,3,10,15,15,2,0.2,"[0, 20, 40]",0.0003,0.0015,0.001,3
3860,0.01104999999999922,0.68,2,11,12,25,21,4,10,15,15,2,0.2,"[0, 20, 40]",0.0003,0.0015,0.001,5
3861,0.003139999999999652,0.5714285714285714,1,1,5,7,7,0,10,15,15,2,0.2,"[0, 20, 40]",0.0003,0.0015,0.0015,1
3862,0.004029999999998796,0.4444444444444444,2,4,12,18,15,3,10,15,15,2,0.2,"[0, 20, 40]",0.0003,0.0015,0.0015,3
3863,0.00894999999999895,0.56,3,6,16,25,21,4,10,15,15,2,0.2,"[0, 20, 40]",0.0003,0.0015,0.0015,5
3864,0.0031399999999997628,0.5714285714285714,1,2,4,7,7,0,10,15,15,2,0.2,"[0, 20, 40]",0.0003,0.002,0.001,1
3865,0.006469999999999238,0.5555555555555556,2,7,9,18,15,3,10,15,15,2,0.2,"[0, 20, 40]",0.0003,0.002,0.001,3
3866,0.012049999999999221,0.68,2,11,12,25,21,4,10,15,15,2,0.2,"[0, 20, 40]",0.0003,0.002,0.001,5
3867,0.003639999999999652,0.5714285714285714,1,1,5,7,7,0,10,15,15,2,0.2,"[0, 20, 40]",0.0003,0.002,0.0015,1
3868,0.005029999999998796,0.4444444444444444,2,4,12,18,15,3,10,15,15,2,0.2,"[0, 20, 40]",0.0003,0.002,0.0015,3
3869,0.010449999999998948,0.56,3,6,16,25,21,4,10,15,15,2,0.2,"[0, 20, 40]",0.0003,0.002,0.0015,5
3870,0.0005499999999998725,0.3333333333333333,1,0,2,3,3,0,10,15,15,2,0.2,"[0, 20, 40]",0.0005,0.001,0.001,1
3871,0.004459999999999749,0.5833333333333334,3,4,5,12,11,1,10,15,15,2,0.2,"[0, 20, 40]",0.0005,0.001,0.001,3
3872,0.0066899999999995696,0.6111111111111112,5,6,7,18,17,1,10,15,15,2,0.2,"[0, 20, 40]",0.0005,0.001,0.001,5
3873,0.0005499999999998725,0.3333333333333333,1,0,2,3,3,0,10,15,15,2,0.2,"[0, 20, 40]",0.0005,0.001,0.0015,1
3874,0.004649999999999494,0.5,3,3,6,12,11,1,10,15,15,2,0.2,"[0, 20, 40]",0.0005,0.001,0.0015,3
3875,0.007879999999999313,0.5555555555555556,5,5,8,18,17,1,10,15,15,2,0.2,"[0, 20, 40]",0.0005,0.001,0.0015,5
3876,0.0004999999999996569,0.3333333333333333,0,0,3,3,3,0,10,15,15,2,0.2,"[0, 20, 40]",0.0005,0.0015,0.001,1
3877,0.005159999999999507,0.5833333333333334,1,4,7,12,11,1,10,15,15,2,0.2,"[0, 20, 40]",0.0005,0.0015,0.001,3
3878,0.008049999999999155,0.6111111111111112,2,6,10,18,17,1,10,15,15,2,0.2,"[0, 20, 40]",0.0005,0.0015,0.001,5
3879,0.0004999999999996569,0.3333333333333333,0,0,3,3,3,0,10,15,15,2,0.2,"[0, 20, 40]",0.0005,0.0015,0.0015,1
3880,0.005349999999999251,0.5,1,3,8,12,11,1,10,15,15,2,0.2,"[0, 20, 40]",0.0005,0.0015,0.0015,3
3881,0.009239999999998897,0.5555555555555556,2,5,11,18,17,1,10,15,15,2,0.2,"[0, 20, 40]",0.0005,0.0015,0.0015,5
3882,0.0004999999999996569,0.3333333333333333,0,0,3,3,3,0,10,15,15,2,0.2,"[0, 20, 40]",0.0005,0.002,0.001,1
3883,0.0056599999999995074,0.5833333333333334,1,4,7,12,11,1,10,15,15,2,0.2,"[0, 20, 40]",0.0005,0.002,0.001,3
3884,0.009049999999999152,0.6111111111111112,2,6,10,18,17,1,10,15,15,2,0.2,"[0, 20, 40]",0.0005,0.002,0.001,5
3885,0.0004999999999996569,0.3333333333333333,0,0,3,3,3,0,10,15,15,2,0.2,"[0, 20, 40]",0.0005,0.002,0.0015,1
3886,0.005849999999999252,0.5,1,3,8,12,11,1,10,15,15,2,0.2,"[0, 20, 40]",0.0005,0.002,0.0015,3
3887,0.010239999999998894,0.5555555555555556,2,5,11,18,17,1,10,15,15,2,0.2,"[0, 20, 40]",0.0005,0.002,0.0015,5
3888,0.01899999999999971,0.75,11,9,8,28,15,13,10,15,20,1,0.1,"[0, 20, 40]",0.0003,0.001,0.001,1
3889,0.02962999999999967,0.7272727272727273,18,20,17,55,31,24,10,15,20,1,0.1,"[0, 20, 40]",0.0003,0.001,0.001,3
3890,0.03719999999999931,0.7428571428571429,24,25,21,70,44,26,10,15,20,1,0.1,"[0, 20, 40]",0.0003,0.001,0.001,5
3891,0.01864999999999975,0.6785714285714286,12,6,10,28,15,13,10,15,20,1,0.1,"[0, 20, 40]",0.0003,0.001,0.0015,1
3892,0.022619999999999724,0.5818181818181818,18,12,25,55,31,24,10,15,20,1,0.1,"[0, 20, 40]",0.0003,0.001,0.0015,3
3893,0.03088999999999934,0.6231884057971014,25,15,29,69,43,26,10,15,20,1,0.1,"[0, 20, 40]",0.0003,0.001,0.0015,5
3894,0.027729999999999387,0.75,6,11,11,28,15,13,10,15,20,1,0.1,"[0, 20, 40]",0.0003,0.0015,0.001,1
3895,0.039139999999999,0.7090909090909091,9,23,23,55,31,24,10,15,20,1,0.1,"[0, 20, 40]",0.0003,0.0015,0.001,3
3896,0.047279999999998226,0.7285714285714285,12,28,30,70,44,26,10,15,20,1,0.1,"[0, 20, 40]",0.0003,0.0015,0.001,5
3897,0.028879999999999423,0.6785714285714286,9,6,13,28,15,13,10,15,20,1,0.1,"[0, 20, 40]",0.0003,0.0015,0.0015,1
3898,0.033629999999999036,0.5636363636363636,11,13,31,55,31,24,10,15,20,1,0.1,"[0, 20, 40]",0.0003,0.0015,0.0015,3
3899,0.04296999999999825,0.6086956521739131,15,16,38,69,43,26,10,15,20,1,0.1,"[0, 20, 40]",0.0003,0.0015,0.0015,5
3900,0.028019999999999184,0.75,3,11,14,28,15,13,10,15,20,1,0.1,"[0, 20, 40]",0.0003,0.002,0.001,1
3901,0.04097999999999891,0.7090909090909091,6,23,26,55,31,24,10,15,20,1,0.1,"[0, 20, 40]",0.0003,0.002,0.001,3
3902,0.047049999999997975,0.7246376811594203,6,27,36,69,44,25,10,15,20,1,0.1,"[0, 20, 40]",0.0003,0.002,0.001,5
3903,0.029879999999999383,0.6785714285714286,5,6,17,28,15,13,10,15,20,1,0.1,"[0, 20, 40]",0.0003,0.002,0.0015,1
3904,0.036469999999998955,0.5636363636363636,8,13,34,55,31,24,10,15,20,1,0.1,"[0, 20, 40]",0.0003,0.002,0.0015,3
3905,0.04373999999999801,0.6029411764705882,9,15,44,68,43,25,10,15,20,1,0.1,"[0, 20, 40]",0.0003,0.002,0.0015,5
3906,0.0038899999999999235,0.8333333333333334,4,1,1,6,3,3,10,15,20,1,0.1,"[0, 20, 40]",0.0005,0.001,0.001,1
3907,0.014630000000000002,0.8076923076923077,10,10,6,26,16,10,10,15,20,1,0.1,"[0, 20, 40]",0.0005,0.001,0.001,3
3908,0.020049999999999662,0.775,14,14,12,40,29,11,10,15,20,1,0.1,"[0, 20, 40]",0.0005,0.001,0.001,5
3909,0.0038899999999999235,0.8333333333333334,5,0,1,6,3,3,10,15,20,1,0.1,"[0, 20, 40]",0.0005,0.001,0.0015,1
3910,0.015479999999999957,0.7307692307692307,11,7,8,26,16,10,10,15,20,1,0.1,"[0, 20, 40]",0.0005,0.001,0.0015,3
3911,0.020139999999999523,0.7,16,9,15,40,29,11,10,15,20,1,0.1,"[0, 20, 40]",0.0005,0.001,0.0015,5
3912,0.0034699999999998933,0.6666666666666666,1,2,3,6,3,3,10,15,20,1,0.1,"[0, 20, 40]",0.0005,0.0015,0.001,1
3913,0.016289999999999992,0.7692307692307693,6,11,9,26,16,10,10,15,20,1,0.1,"[0, 20, 40]",0.0005,0.0015,0.001,3
3914,0.023059999999999446,0.75,9,15,16,40,29,11,10,15,20,1,0.1,"[0, 20, 40]",0.0005,0.0015,0.001,5
3915,0.00214999999999985,0.5,2,0,4,6,3,3,10,15,20,1,0.1,"[0, 20, 40]",0.0005,0.0015,0.0015,1
3916,0.015819999999999904,0.6538461538461539,7,7,12,26,16,10,10,15,20,1,0.1,"[0, 20, 40]",0.0005,0.0015,0.0015,3
3917,0.02232999999999927,0.65,11,9,20,40,29,11,10,15,20,1,0.1,"[0, 20, 40]",0.0005,0.0015,0.0015,5
3918,0.003969999999999894,0.6666666666666666,1,2,3,6,3,3,10,15,20,1,0.1,"[0, 20, 40]",0.0005,0.002,0.001,1
3919,0.01856999999999994,0.7692307692307693,5,11,10,26,16,10,10,15,20,1,0.1,"[0, 20, 40]",0.0005,0.002,0.001,3
3920,0.026839999999999392,0.75,8,15,17,40,29,11,10,15,20,1,0.1,"[0, 20, 40]",0.0005,0.002,0.001,5
3921,0.00314999999999985,0.5,2,0,4,6,3,3,10,15,20,1,0.1,"[0, 20, 40]",0.0005,0.002,0.0015,1
3922,0.018599999999999853,0.6538461538461539,6,7,13,26,16,10,10,15,20,1,0.1,"[0, 20, 40]",0.0005,0.002,0.0015,3
3923,0.02710999999999922,0.65,10,9,21,40,29,11,10,15,20,1,0.1,"[0, 20, 40]",0.0005,0.002,0.0015,5
3924,0.007889999999999881,0.7692307692307693,7,3,3,13,10,3,10,15,20,1,0.2,"[0, 20, 40]",0.0003,0.001,0.001,1
3925,0.01173000000000001,0.72,9,8,8,25,18,7,10,15,20,1,0.2,"[0, 20, 40]",0.0003,0.001,0.001,3
3926,0.01733000000000001,0.78125,13,11,8,32,24,8,10,15,20,1,0.2,"[0, 20, 40]",0.0003,0.001,0.001,5
3927,0.009389999999999881,0.7692307692307693,7,3,3,13,10,3,10,15,20,1,0.2,"[0, 20, 40]",0.0003,0.001,0.0015,1
3928,0.011499999999999943,0.64,9,6,10,25,18,7,10,15,20,1,0.2,"[0, 20, 40]",0.0003,0.001,0.0015,3
3929,0.01859999999999994,0.71875,13,9,10,32,24,8,10,15,20,1,0.2,"[0, 20, 40]",0.0003,0.001,0.0015,5
3930,0.010019999999999788,0.7692307692307693,5,4,4,13,10,3,10,15,20,1,0.2,"[0, 20, 40]",0.0003,0.0015,0.001,1
3931,0.014229999999999679,0.72,5,9,11,25,18,7,10,15,20,1,0.2,"[0, 20, 40]",0.0003,0.0015,0.001,3
3932,0.020249999999999428,0.78125,7,12,13,32,24,8,10,15,20,1,0.2,"[0, 20, 40]",0.0003,0.0015,0.001,5
3933,0.012019999999999784,0.7692307692307693,6,3,4,13,10,3,10,15,20,1,0.2,"[0, 20, 40]",0.0003,0.0015,0.0015,1
3934,0.014499999999999614,0.64,6,6,13,25,18,7,10,15,20,1,0.2,"[0, 20, 40]",0.0003,0.0015,0.0015,3
3935,0.022019999999999363,0.71875,8,9,15,32,24,8,10,15,20,1,0.2,"[0, 20, 40]",0.0003,0.0015,0.0015,5
3936,0.009809999999999583,0.7692307692307693,2,4,7,13,10,3,10,15,20,1,0.2,"[0, 20, 40]",0.0003,0.002,0.001,1
3937,0.015059999999999619,0.72,3,9,13,25,18,7,10,15,20,1,0.2,"[0, 20, 40]",0.0003,0.002,0.001,3
3938,0.01928999999999922,0.7741935483870968,3,11,17,31,24,7,10,15,20,1,0.2,"[0, 20, 40]",0.0003,0.002,0.001,5
3939,0.012309999999999582,0.7692307692307693,3,3,7,13,10,3,10,15,20,1,0.2,"[0, 20, 40]",0.0003,0.002,0.0015,1
3940,0.015829999999999556,0.64,4,6,15,25,18,7,10,15,20,1,0.2,"[0, 20, 40]",0.0003,0.002,0.0015,3
3941,0.021059999999999156,0.7096774193548387,4,8,19,31,24,7,10,15,20,1,0.2,"[0, 20, 40]",0.0003,0.002,0.0015,5
3942,0.0022899999999999236,0.75,3,0,1,4,3,1,10,15,20,1,0.2,"[0, 20, 40]",0.0005,0.001,0.001,1
3943,0.009320000000000078,0.8125,6,6,4,16,13,3,10,15,20,1,0.2,"[0, 20, 40]",0.0005,0.001,0.001,3
3944,0.012099999999999948,0.8181818181818182,7,9,6,22,19,3,10,15,20,1,0.2,"[0, 20, 40]",0.0005,0.001,0.001,5
3945,0.0022899999999999236,0.75,3,0,1,4,3,1,10,15,20,1,0.2,"[0, 20, 40]",0.0005,0.001,0.0015,1
3946,0.01081000000000001,0.75,6,5,5,16,13,3,10,15,20,1,0.2,"[0, 20, 40]",0.0005,0.001,0.0015,3
3947,0.012829999999999784,0.7272727272727273,7,7,8,22,19,3,10,15,20,1,0.2,"[0, 20, 40]",0.0005,0.001,0.0015,5
3948,0.00261999999999981,0.75,1,1,2,4,3,1,10,15,20,1,0.2,"[0, 20, 40]",0.0005,0.0015,0.001,1
3949,0.011149999999999962,0.8125,4,7,5,16,13,3,10,15,20,1,0.2,"[0, 20, 40]",0.0005,0.0015,0.001,3
3950,0.013779999999999626,0.8181818181818182,4,10,8,22,19,3,10,15,20,1,0.2,"[0, 20, 40]",0.0005,0.0015,0.001,5
3951,0.0007999999999997668,0.5,1,0,3,4,3,1,10,15,20,1,0.2,"[0, 20, 40]",0.0005,0.0015,0.0015,1
3952,0.01081999999999985,0.6875,4,5,7,16,13,3,10,15,20,1,0.2,"[0, 20, 40]",0.0005,0.0015,0.0015,3
3953,0.012689999999999424,0.6818181818181818,4,7,11,22,19,3,10,15,20,1,0.2,"[0, 20, 40]",0.0005,0.0015,0.0015,5
3954,0.00311999999999981,0.75,1,1,2,4,3,1,10,15,20,1,0.2,"[0, 20, 40]",0.0005,0.002,0.001,1
3955,0.01242999999999991,0.8125,3,7,6,16,13,3,10,15,20,1,0.2,"[0, 20, 40]",0.0005,0.002,0.001,3
3956,0.015059999999999574,0.8181818181818182,3,10,9,22,19,3,10,15,20,1,0.2,"[0, 20, 40]",0.0005,0.002,0.001,5
3957,0.0012999999999997668,0.5,1,0,3,4,3,1,10,15,20,1,0.2,"[0, 20, 40]",0.0005,0.002,0.0015,1
3958,0.0120999999999998,0.6875,3,5,8,16,13,3,10,15,20,1,0.2,"[0, 20, 40]",0.0005,0.002,0.0015,3
3959,0.01396999999999937,0.6818181818181818,3,7,12,22,19,3,10,15,20,1,0.2,"[0, 20, 40]",0.0005,0.002,0.0015,5
3960,0.010739999999999793,0.6111111111111112,6,4,8,18,12,6,10,15,20,2,0.1,"[0, 20, 40]",0.0003,0.001,0.001,1
3961,0.020839999999999706,0.6585365853658537,12,14,15,41,27,14,10,15,20,2,0.1,"[0, 20, 40]",0.0003,0.001,0.001,3
3962,0.028509999999999574,0.7037037037037037,18,19,17,54,39,15,10,15,20,2,0.1,"[0, 20, 40]",0.0003,0.001,0.001,5
3963,0.01273999999999979,0.6111111111111112,6,4,8,18,12,6,10,15,20,2,0.1,"[0, 20, 40]",0.0003,0.001,0.0015,1
3964,0.02071999999999964,0.5853658536585366,12,11,18,41,27,14,10,15,20,2,0.1,"[0, 20, 40]",0.0003,0.001,0.0015,3
3965,0.029089999999999512,0.6415094339622641,19,14,20,53,38,15,10,15,20,2,0.1,"[0, 20, 40]",0.0003,0.001,0.0015,5
3966,0.017469999999999465,0.6111111111111112,2,5,11,18,12,6,10,15,20,2,0.1,"[0, 20, 40]",0.0003,0.0015,0.001,1
3967,0.027579999999999008,0.6341463414634146,4,16,21,41,27,14,10,15,20,2,0.1,"[0, 20, 40]",0.0003,0.0015,0.001,3
3968,0.034999999999998664,0.6792452830188679,7,21,25,53,39,14,10,15,20,2,0.1,"[0, 20, 40]",0.0003,0.0015,0.001,5
3969,0.019969999999999464,0.6111111111111112,3,4,11,18,12,6,10,15,20,2,0.1,"[0, 20, 40]",0.0003,0.0015,0.0015,1
3970,0.028459999999998938,0.5609756097560976,5,12,24,41,27,14,10,15,20,2,0.1,"[0, 20, 40]",0.0003,0.0015,0.0015,3
3971,0.0370799999999986,0.6153846153846154,9,15,28,52,38,14,10,15,20,2,0.1,"[0, 20, 40]",0.0003,0.0015,0.0015,5
3972,0.018469999999999463,0.6111111111111112,2,5,11,18,12,6,10,15,20,2,0.1,"[0, 20, 40]",0.0003,0.002,0.001,1
3973,0.028589999999998963,0.6341463414634146,3,16,22,41,27,14,10,15,20,2,0.1,"[0, 20, 40]",0.0003,0.002,0.001,3
3974,0.034739999999998473,0.6792452830188679,3,21,29,53,39,14,10,15,20,2,0.1,"[0, 20, 40]",0.0003,0.002,0.001,5
3975,0.021469999999999465,0.6111111111111112,3,4,11,18,12,6,10,15,20,2,0.1,"[0, 20, 40]",0.0003,0.002,0.0015,1
3976,0.029969999999998893,0.5609756097560976,4,12,25,41,27,14,10,15,20,2,0.1,"[0, 20, 40]",0.0003,0.002,0.0015,3
3977,0.037819999999998404,0.6153846153846154,5,15,32,52,38,14,10,15,20,2,0.1,"[0, 20, 40]",0.0003,0.002,0.0015,5
3978,0.004010000000000021,0.7142857142857143,4,1,2,7,5,2,10,15,20,2,0.1,"[0, 20, 40]",0.0005,0.001,0.001,1
3979,0.013440000000000177,0.8181818181818182,8,9,5,22,17,5,10,15,20,2,0.1,"[0, 20, 40]",0.0005,0.001,0.001,3
3980,0.018690000000000016,0.7878787878787878,12,12,9,33,28,5,10,15,20,2,0.1,"[0, 20, 40]",0.0005,0.001,0.001,5
3981,0.004510000000000022,0.7142857142857143,4,1,2,7,5,2,10,15,20,2,0.1,"[0, 20, 40]",0.0005,0.001,0.0015,1
3982,0.016430000000000104,0.7727272727272727,8,8,6,22,17,5,10,15,20,2,0.1,"[0, 20, 40]",0.0005,0.001,0.0015,3
3983,0.020919999999999855,0.7272727272727273,12,10,11,33,28,5,10,15,20,2,0.1,"[0, 20, 40]",0.0005,0.001,0.0015,5
3984,0.003589999999999991,0.5714285714285714,1,2,4,7,5,2,10,15,20,2,0.1,"[0, 20, 40]",0.0005,0.0015,0.001,1
3985,0.014100000000000168,0.7727272727272727,4,10,8,22,17,5,10,15,20,2,0.1,"[0, 20, 40]",0.0005,0.0015,0.001,3
3986,0.020699999999999802,0.7575757575757576,7,13,13,33,28,5,10,15,20,2,0.1,"[0, 20, 40]",0.0005,0.0015,0.001,5
3987,0.0022699999999999483,0.42857142857142855,1,1,5,7,5,2,10,15,20,2,0.1,"[0, 20, 40]",0.0005,0.0015,0.0015,1
3988,0.015270000000000054,0.6818181818181818,4,8,10,22,17,5,10,15,20,2,0.1,"[0, 20, 40]",0.0005,0.0015,0.0015,3
3989,0.0211099999999996,0.6666666666666666,7,10,16,33,28,5,10,15,20,2,0.1,"[0, 20, 40]",0.0005,0.0015,0.0015,5
3990,0.004089999999999991,0.5714285714285714,1,2,4,7,5,2,10,15,20,2,0.1,"[0, 20, 40]",0.0005,0.002,0.001,1
3991,0.015380000000000118,0.7727272727272727,3,10,9,22,17,5,10,15,20,2,0.1,"[0, 20, 40]",0.0005,0.002,0.001,3
3992,0.023479999999999748,0.7575757575757576,6,13,14,33,28,5,10,15,20,2,0.1,"[0, 20, 40]",0.0005,0.002,0.001,5
3993,0.0027699999999999483,0.42857142857142855,1,1,5,7,5,2,10,15,20,2,0.1,"[0, 20, 40]",0.0005,0.002,0.0015,1
3994,0.016550000000000006,0.6818181818181818,3,8,11,22,17,5,10,15,20,2,0.1,"[0, 20, 40]",0.0005,0.002,0.0015,3
3995,0.02388999999999955,0.6666666666666666,6,10,17,33,28,5,10,15,20,2,0.1,"[0, 20, 40]",0.0005,0.002,0.0015,5
3996,0.0037099999999998324,0.7142857142857143,3,2,2,7,7,0,10,15,20,2,0.2,"[0, 20, 40]",0.0003,0.001,0.001,1
3997,0.00781999999999991,0.6875,3,8,5,16,13,3,10,15,20,2,0.2,"[0, 20, 40]",0.0003,0.001,0.001,3
3998,0.013419999999999913,0.782608695652174,6,12,5,23,19,4,10,15,20,2,0.2,"[0, 20, 40]",0.0003,0.001,0.001,5
3999,0.004709999999999832,0.7142857142857143,3,2,2,7,7,0,10,15,20,2,0.2,"[0, 20, 40]",0.0003,0.001,0.0015,1
4000,0.0046999999999998415,0.5,3,5,8,16,13,3,10,15,20,2,0.2,"[0, 20, 40]",0.0003,0.001,0.0015,3
4001,0.01179999999999984,0.6521739130434783,7,8,8,23,19,4,10,15,20,2,0.2,"[0, 20, 40]",0.0003,0.001,0.0015,5
4002,0.0038399999999997408,0.7142857142857143,1,3,3,7,7,0,10,15,20,2,0.2,"[0, 20, 40]",0.0003,0.0015,0.001,1
4003,0.00744999999999982,0.6875,0,10,6,16,13,3,10,15,20,2,0.2,"[0, 20, 40]",0.0003,0.0015,0.001,3
4004,0.012969999999999574,0.782608695652174,1,14,8,23,19,4,10,15,20,2,0.2,"[0, 20, 40]",0.0003,0.0015,0.001,5
4005,0.00533999999999974,0.7142857142857143,2,2,3,7,7,0,10,15,20,2,0.2,"[0, 20, 40]",0.0003,0.0015,0.0015,1
4006,0.00532999999999975,0.5,1,6,9,16,13,3,10,15,20,2,0.2,"[0, 20, 40]",0.0003,0.0015,0.0015,3
4007,0.012849999999999504,0.6521739130434783,3,9,11,23,19,4,10,15,20,2,0.2,"[0, 20, 40]",0.0003,0.0015,0.0015,5
4008,0.004339999999999741,0.7142857142857143,1,3,3,7,7,0,10,15,20,2,0.2,"[0, 20, 40]",0.0003,0.002,0.001,1
4009,0.00744999999999982,0.6875,0,10,6,16,13,3,10,15,20,2,0.2,"[0, 20, 40]",0.0003,0.002,0.001,3
4010,0.01241999999999958,0.782608695652174,0,14,9,23,19,4,10,15,20,2,0.2,"[0, 20, 40]",0.0003,0.002,0.001,5
4011,0.00633999999999974,0.7142857142857143,2,2,3,7,7,0,10,15,20,2,0.2,"[0, 20, 40]",0.0003,0.002,0.0015,1
4012,0.00582999999999975,0.5,1,6,9,16,13,3,10,15,20,2,0.2,"[0, 20, 40]",0.0003,0.002,0.0015,3
4013,0.01329999999999951,0.6521739130434783,2,9,12,23,19,4,10,15,20,2,0.2,"[0, 20, 40]",0.0003,0.002,0.0015,5
4014,0.0014899999999999237,0.6666666666666666,1,1,1,3,3,0,10,15,20,2,0.2,"[0, 20, 40]",0.0005,0.001,0.001,1
4015,0.005320000000000076,0.7272727272727273,2,5,4,11,10,1,10,15,20,2,0.2,"[0, 20, 40]",0.0005,0.001,0.001,3
4016,0.009760000000000052,0.8235294117647058,4,8,5,17,16,1,10,15,20,2,0.2,"[0, 20, 40]",0.0005,0.001,0.001,5
4017,0.0019899999999999233,0.6666666666666666,1,1,1,3,3,0,10,15,20,2,0.2,"[0, 20, 40]",0.0005,0.001,0.0015,1
4018,0.006310000000000011,0.6363636363636364,2,4,5,11,10,1,10,15,20,2,0.2,"[0, 20, 40]",0.0005,0.001,0.0015,3
4019,0.00998999999999989,0.7058823529411765,4,6,7,17,16,1,10,15,20,2,0.2,"[0, 20, 40]",0.0005,0.001,0.0015,5
4020,0.00131999999999981,0.6666666666666666,0,1,2,3,3,0,10,15,20,2,0.2,"[0, 20, 40]",0.0005,0.0015,0.001,1
4021,0.005649999999999962,0.7272727272727273,1,5,5,11,10,1,10,15,20,2,0.2,"[0, 20, 40]",0.0005,0.0015,0.001,3
4022,0.01043999999999973,0.8235294117647058,2,8,7,17,16,1,10,15,20,2,0.2,"[0, 20, 40]",0.0005,0.0015,0.001,5
4023,0.0018199999999998098,0.6666666666666666,0,1,2,3,3,0,10,15,20,2,0.2,"[0, 20, 40]",0.0005,0.0015,0.0015,1
4024,0.006639999999999897,0.6363636363636364,1,4,6,11,10,1,10,15,20,2,0.2,"[0, 20, 40]",0.0005,0.0015,0.0015,3
4025,0.010669999999999569,0.7058823529411765,2,6,9,17,16,1,10,15,20,2,0.2,"[0, 20, 40]",0.0005,0.0015,0.0015,5
4026,0.00131999999999981,0.6666666666666666,0,1,2,3,3,0,10,15,20,2,0.2,"[0, 20, 40]",0.0005,0.002,0.001,1
4027,0.006149999999999963,0.7272727272727273,1,5,5,11,10,1,10,15,20,2,0.2,"[0, 20, 40]",0.0005,0.002,0.001,3
4028,0.011439999999999732,0.8235294117647058,2,8,7,17,16,1,10,15,20,2,0.2,"[0, 20, 40]",0.0005,0.002,0.001,5
4029,0.0018199999999998098,0.6666666666666666,0,1,2,3,3,0,10,15,20,2,0.2,"[0, 20, 40]",0.0005,0.002,0.0015,1
4030,0.007139999999999896,0.6363636363636364,1,4,6,11,10,1,10,15,20,2,0.2,"[0, 20, 40]",0.0005,0.002,0.0015,3
4031,0.01166999999999957,0.7058823529411765,2,6,9,17,16,1,10,15,20,2,0.2,"[0, 20, 40]",0.0005,0.002,0.0015,5
4032,0.006489999999998908,0.4117647058823529,5,7,22,34,19,15,10,16,5,1,0.1,"[0, 20, 40]",0.0003,0.001,0.001,1
4033,-0.0005200000000025187,0.29333333333333333,6,9,60,75,45,30,10,16,5,1,0.1,"[0, 20, 40]",0.0003,0.001,0.001,3
4034,-0.004000000000003641,0.2553191489361702,6,10,78,94,62,32,10,16,5,1,0.1,"[0, 20, 40]",0.0003,0.001,0.001,5
4035,0.0040699999999989295,0.3235294117647059,5,4,25,34,19,15,10,16,5,1,0.1,"[0, 20, 40]",0.0003,0.001,0.0015,1
4036,-0.006930000000002653,0.22666666666666666,6,4,65,75,45,30,10,16,5,1,0.1,"[0, 20, 40]",0.0003,0.001,0.0015,3
4037,-0.010410000000003779,0.20212765957446807,7,4,83,94,62,32,10,16,5,1,0.1,"[0, 20, 40]",0.0003,0.001,0.0015,5
4038,0.005199999999998674,0.38235294117647056,0,8,26,34,19,15,10,16,5,1,0.1,"[0, 20, 40]",0.0003,0.0015,0.001,1
4039,-0.0017400000000028465,0.28,0,10,65,75,45,30,10,16,5,1,0.1,"[0, 20, 40]",0.0003,0.0015,0.001,3
4040,-0.005220000000003969,0.24468085106382978,0,11,83,94,62,32,10,16,5,1,0.1,"[0, 20, 40]",0.0003,0.0015,0.001,5
4041,0.0012599999999988428,0.2647058823529412,0,4,30,34,19,15,10,16,5,1,0.1,"[0, 20, 40]",0.0003,0.0015,0.0015,1
4042,-0.00967000000000284,0.2,0,4,71,75,45,30,10,16,5,1,0.1,"[0, 20, 40]",0.0003,0.0015,0.0015,3
4043,-0.013050000000004088,0.18085106382978725,0,4,90,94,62,32,10,16,5,1,0.1,"[0, 20, 40]",0.0003,0.0015,0.0015,5
4044,0.005199999999998674,0.38235294117647056,0,8,26,34,19,15,10,16,5,1,0.1,"[0, 20, 40]",0.0003,0.002,0.001,1
4045,-0.0017400000000028465,0.28,0,10,65,75,45,30,10,16,5,1,0.1,"[0, 20, 40]",0.0003,0.002,0.001,3
4046,-0.005220000000003969,0.24468085106382978,0,11,83,94,62,32,10,16,5,1,0.1,"[0, 20, 40]",0.0003,0.002,0.001,5
4047,0.0012599999999988428,0.2647058823529412,0,4,30,34,19,15,10,16,5,1,0.1,"[0, 20, 40]",0.0003,0.002,0.0015,1
4048,-0.00967000000000284,0.2,0,4,71,75,45,30,10,16,5,1,0.1,"[0, 20, 40]",0.0003,0.002,0.0015,3
4049,-0.013050000000004088,0.18085106382978725,0,4,90,94,62,32,10,16,5,1,0.1,"[0, 20, 40]",0.0003,0.002,0.0015,5
4050,0.0024199999999995545,0.6666666666666666,1,2,6,9,5,4,10,16,5,1,0.1,"[0, 20, 40]",0.0005,0.001,0.001,1
4051,0.005469999999998289,0.5,5,6,25,36,23,13,10,16,5,1,0.1,"[0, 20, 40]",0.0005,0.001,0.001,3
4052,0.002279999999997325,0.41509433962264153,6,6,41,53,39,14,10,16,5,1,0.1,"[0, 20, 40]",0.0005,0.001,0.001,5
4053,-0.0021200000000006548,0.4444444444444444,1,0,8,9,5,4,10,16,5,1,0.1,"[0, 20, 40]",0.0005,0.001,0.0015,1
4054,-0.006940000000002183,0.3333333333333333,5,0,31,36,23,13,10,16,5,1,0.1,"[0, 20, 40]",0.0005,0.001,0.0015,3
4055,-0.010130000000003143,0.3018867924528302,6,0,47,53,39,14,10,16,5,1,0.1,"[0, 20, 40]",0.0005,0.001,0.0015,5
4056,0.0014499999999995291,0.5555555555555556,0,2,7,9,5,4,10,16,5,1,0.1,"[0, 20, 40]",0.0005,0.0015,0.001,1
4057,0.003879999999998142,0.4444444444444444,1,6,29,36,23,13,10,16,5,1,0.1,"[0, 20, 40]",0.0005,0.0015,0.001,3
4058,0.0009899999999970375,0.37735849056603776,1,6,46,53,39,14,10,16,5,1,0.1,"[0, 20, 40]",0.0005,0.0015,0.001,5
4059,-0.0030900000000006803,0.3333333333333333,0,0,9,9,5,4,10,16,5,1,0.1,"[0, 20, 40]",0.0005,0.0015,0.0015,1
4060,-0.00853000000000233,0.2777777777777778,1,0,35,36,23,13,10,16,5,1,0.1,"[0, 20, 40]",0.0005,0.0015,0.0015,3
4061,-0.011420000000003436,0.2641509433962264,1,0,52,53,39,14,10,16,5,1,0.1,"[0, 20, 40]",0.0005,0.0015,0.0015,5
4062,0.0014499999999995291,0.5555555555555556,0,2,7,9,5,4,10,16,5,1,0.1,"[0, 20, 40]",0.0005,0.002,0.001,1
4063,0.004139999999998126,0.4444444444444444,0,6,30,36,23,13,10,16,5,1,0.1,"[0, 20, 40]",0.0005,0.002,0.001,3
4064,0.0012499999999970217,0.37735849056603776,0,6,47,53,39,14,10,16,5,1,0.1,"[0, 20, 40]",0.0005,0.002,0.001,5
4065,-0.0030900000000006803,0.3333333333333333,0,0,9,9,5,4,10,16,5,1,0.1,"[0, 20, 40]",0.0005,0.002,0.0015,1
4066,-0.008270000000002347,0.2777777777777778,0,0,36,36,23,13,10,16,5,1,0.1,"[0, 20, 40]",0.0005,0.002,0.0015,3
4067,-0.011160000000003452,0.2641509433962264,0,0,53,53,39,14,10,16,5,1,0.1,"[0, 20, 40]",0.0005,0.002,0.0015,5
4068,0.003699999999999568,0.4375,3,2,11,16,13,3,10,16,5,1,0.2,"[0, 20, 40]",0.0003,0.001,0.001,1
4069,-0.001120000000000964,0.3333333333333333,3,3,27,33,26,7,10,16,5,1,0.2,"[0, 20, 40]",0.0003,0.001,0.001,3
4070,-0.0042100000000009985,0.2558139534883721,3,3,37,43,35,8,10,16,5,1,0.2,"[0, 20, 40]",0.0003,0.001,0.001,5
4071,0.00469999999999957,0.4375,3,2,11,16,13,3,10,16,5,1,0.2,"[0, 20, 40]",0.0003,0.001,0.0015,1
4072,-0.0019000000000009678,0.30303030303030304,3,2,28,33,26,7,10,16,5,1,0.2,"[0, 20, 40]",0.0003,0.001,0.0015,3
4073,-0.004990000000001001,0.23255813953488372,3,2,38,43,35,8,10,16,5,1,0.2,"[0, 20, 40]",0.0003,0.001,0.0015,5
4074,0.002349999999999497,0.375,0,2,14,16,13,3,10,16,5,1,0.2,"[0, 20, 40]",0.0003,0.0015,0.001,1
4075,-0.0024700000000010347,0.30303030303030304,0,3,30,33,26,7,10,16,5,1,0.2,"[0, 20, 40]",0.0003,0.0015,0.001,3
4076,-0.005560000000001069,0.23255813953488372,0,3,40,43,35,8,10,16,5,1,0.2,"[0, 20, 40]",0.0003,0.0015,0.001,5
4077,0.0033499999999994988,0.375,0,2,14,16,13,3,10,16,5,1,0.2,"[0, 20, 40]",0.0003,0.0015,0.0015,1
4078,-0.0032500000000010385,0.2727272727272727,0,2,31,33,26,7,10,16,5,1,0.2,"[0, 20, 40]",0.0003,0.0015,0.0015,3
4079,-0.006340000000001071,0.20930232558139536,0,2,41,43,35,8,10,16,5,1,0.2,"[0, 20, 40]",0.0003,0.0015,0.0015,5
4080,0.002349999999999497,0.375,0,2,14,16,13,3,10,16,5,1,0.2,"[0, 20, 40]",0.0003,0.002,0.001,1
4081,-0.0024700000000010347,0.30303030303030304,0,3,30,33,26,7,10,16,5,1,0.2,"[0, 20, 40]",0.0003,0.002,0.001,3
4082,-0.005560000000001069,0.23255813953488372,0,3,40,43,35,8,10,16,5,1,0.2,"[0, 20, 40]",0.0003,0.002,0.001,5
4083,0.0033499999999994988,0.375,0,2,14,16,13,3,10,16,5,1,0.2,"[0, 20, 40]",0.0003,0.002,0.0015,1
4084,-0.0032500000000010385,0.2727272727272727,0,2,31,33,26,7,10,16,5,1,0.2,"[0, 20, 40]",0.0003,0.002,0.0015,3
4085,-0.006340000000001071,0.20930232558139536,0,2,41,43,35,8,10,16,5,1,0.2,"[0, 20, 40]",0.0003,0.002,0.0015,5
4086,0.0017999999999995797,0.8,0,1,4,5,4,1,10,16,5,1,0.2,"[0, 20, 40]",0.0005,0.001,0.001,1
4087,0.0012599999999988168,0.45,2,3,15,20,17,3,10,16,5,1,0.2,"[0, 20, 40]",0.0005,0.001,0.001,3
4088,-0.0009800000000016237,0.3448275862068966,2,3,24,29,26,3,10,16,5,1,0.2,"[0, 20, 40]",0.0005,0.001,0.001,5
4089,-0.0004800000000005905,0.6,0,0,5,5,4,1,10,16,5,1,0.2,"[0, 20, 40]",0.0005,0.001,0.0015,1
4090,-0.0050800000000015225,0.3,2,0,18,20,17,3,10,16,5,1,0.2,"[0, 20, 40]",0.0005,0.001,0.0015,3
4091,-0.007320000000001964,0.2413793103448276,2,0,27,29,26,3,10,16,5,1,0.2,"[0, 20, 40]",0.0005,0.001,0.0015,5
4092,0.0017999999999995797,0.8,0,1,4,5,4,1,10,16,5,1,0.2,"[0, 20, 40]",0.0005,0.0015,0.001,1
4093,0.0009799999999987037,0.4,1,3,16,20,17,3,10,16,5,1,0.2,"[0, 20, 40]",0.0005,0.0015,0.001,3
4094,-0.0012600000000017367,0.3103448275862069,1,3,25,29,26,3,10,16,5,1,0.2,"[0, 20, 40]",0.0005,0.0015,0.001,5
4095,-0.0004800000000005905,0.6,0,0,5,5,4,1,10,16,5,1,0.2,"[0, 20, 40]",0.0005,0.0015,0.0015,1
4096,-0.005360000000001636,0.25,1,0,19,20,17,3,10,16,5,1,0.2,"[0, 20, 40]",0.0005,0.0015,0.0015,3
4097,-0.007600000000002074,0.20689655172413793,1,0,28,29,26,3,10,16,5,1,0.2,"[0, 20, 40]",0.0005,0.0015,0.0015,5
4098,0.0017999999999995797,0.8,0,1,4,5,4,1,10,16,5,1,0.2,"[0, 20, 40]",0.0005,0.002,0.001,1
4099,0.0012399999999986875,0.4,0,3,17,20,17,3,10,16,5,1,0.2,"[0, 20, 40]",0.0005,0.002,0.001,3
4100,-0.001000000000001753,0.3103448275862069,0,3,26,29,26,3,10,16,5,1,0.2,"[0, 20, 40]",0.0005,0.002,0.001,5
4101,-0.0004800000000005905,0.6,0,0,5,5,4,1,10,16,5,1,0.2,"[0, 20, 40]",0.0005,0.002,0.0015,1
4102,-0.005100000000001653,0.25,0,0,20,20,17,3,10,16,5,1,0.2,"[0, 20, 40]",0.0005,0.002,0.0015,3
4103,-0.00734000000000209,0.20689655172413793,0,0,29,29,26,3,10,16,5,1,0.2,"[0, 20, 40]",0.0005,0.002,0.0015,5
4104,0.003239999999999263,0.375,3,4,17,24,16,8,10,16,5,2,0.1,"[0, 20, 40]",0.0003,0.001,0.001,1
4105,-0.00414000000000247,0.25,4,6,50,60,43,17,10,16,5,2,0.1,"[0, 20, 40]",0.0003,0.001,0.001,3
4106,-0.006480000000003376,0.2236842105263158,4,7,65,76,58,18,10,16,5,2,0.1,"[0, 20, 40]",0.0003,0.001,0.001,5
4107,0.003679999999999313,0.3333333333333333,3,3,18,24,16,8,10,16,5,2,0.1,"[0, 20, 40]",0.0003,0.001,0.0015,1
4108,-0.007690000000002582,0.2,4,3,53,60,43,17,10,16,5,2,0.1,"[0, 20, 40]",0.0003,0.001,0.0015,3
4109,-0.010030000000003501,0.18421052631578946,5,3,68,76,58,18,10,16,5,2,0.1,"[0, 20, 40]",0.0003,0.001,0.0015,5
4110,0.0014499999999991967,0.3333333333333333,0,4,20,24,16,8,10,16,5,2,0.1,"[0, 20, 40]",0.0003,0.0015,0.001,1
4111,-0.005860000000002632,0.23333333333333334,0,6,54,60,43,17,10,16,5,2,0.1,"[0, 20, 40]",0.0003,0.0015,0.001,3
4112,-0.008200000000003541,0.21052631578947367,0,7,69,76,58,18,10,16,5,2,0.1,"[0, 20, 40]",0.0003,0.0015,0.001,5
4113,0.0018899999999992464,0.2916666666666667,0,3,21,24,16,8,10,16,5,2,0.1,"[0, 20, 40]",0.0003,0.0015,0.0015,1
4114,-0.009410000000002746,0.18333333333333332,0,3,57,60,43,17,10,16,5,2,0.1,"[0, 20, 40]",0.0003,0.0015,0.0015,3
4115,-0.011650000000003788,0.17105263157894737,0,3,73,76,58,18,10,16,5,2,0.1,"[0, 20, 40]",0.0003,0.0015,0.0015,5
4116,0.0014499999999991967,0.3333333333333333,0,4,20,24,16,8,10,16,5,2,0.1,"[0, 20, 40]",0.0003,0.002,0.001,1
4117,-0.005860000000002632,0.23333333333333334,0,6,54,60,43,17,10,16,5,2,0.1,"[0, 20, 40]",0.0003,0.002,0.001,3
4118,-0.008200000000003541,0.21052631578947367,0,7,69,76,58,18,10,16,5,2,0.1,"[0, 20, 40]",0.0003,0.002,0.001,5
4119,0.0018899999999992464,0.2916666666666667,0,3,21,24,16,8,10,16,5,2,0.1,"[0, 20, 40]",0.0003,0.002,0.0015,1
4120,-0.009410000000002746,0.18333333333333332,0,3,57,60,43,17,10,16,5,2,0.1,"[0, 20, 40]",0.0003,0.002,0.0015,3
4121,-0.011650000000003788,0.17105263157894737,0,3,73,76,58,18,10,16,5,2,0.1,"[0, 20, 40]",0.0003,0.002,0.0015,5
4122,0.002489999999999769,0.6,1,2,7,10,7,3,10,16,5,2,0.1,"[0, 20, 40]",0.0005,0.001,0.001,1
4123,0.0030299999999987533,0.4666666666666667,3,5,22,30,24,6,10,16,5,2,0.1,"[0, 20, 40]",0.0005,0.001,0.001,3
4124,0.0014299999999982638,0.4,4,5,36,45,39,6,10,16,5,2,0.1,"[0, 20, 40]",0.0005,0.001,0.001,5
4125,-0.0020500000000004404,0.4,1,0,9,10,7,3,10,16,5,2,0.1,"[0, 20, 40]",0.0005,0.001,0.0015,1
4126,-0.007580000000001806,0.3,3,0,27,30,24,6,10,16,5,2,0.1,"[0, 20, 40]",0.0005,0.001,0.0015,3
4127,-0.009180000000002292,0.28888888888888886,4,0,41,45,39,6,10,16,5,2,0.1,"[0, 20, 40]",0.0005,0.001,0.0015,5
4128,0.0015199999999997433,0.5,0,2,8,10,7,3,10,16,5,2,0.1,"[0, 20, 40]",0.0005,0.0015,0.001,1
4129,0.001419999999998533,0.4,0,5,25,30,24,6,10,16,5,2,0.1,"[0, 20, 40]",0.0005,0.0015,0.001,3
4130,0.00011999999999790122,0.35555555555555557,0,5,40,45,39,6,10,16,5,2,0.1,"[0, 20, 40]",0.0005,0.0015,0.001,5
4131,-0.003020000000000466,0.3,0,0,10,10,7,3,10,16,5,2,0.1,"[0, 20, 40]",0.0005,0.0015,0.0015,1
4132,-0.009190000000002026,0.23333333333333334,0,0,30,30,24,6,10,16,5,2,0.1,"[0, 20, 40]",0.0005,0.0015,0.0015,3
4133,-0.010490000000002659,0.24444444444444444,0,0,45,45,39,6,10,16,5,2,0.1,"[0, 20, 40]",0.0005,0.0015,0.0015,5
4134,0.0015199999999997433,0.5,0,2,8,10,7,3,10,16,5,2,0.1,"[0, 20, 40]",0.0005,0.002,0.001,1
4135,0.001419999999998533,0.4,0,5,25,30,24,6,10,16,5,2,0.1,"[0, 20, 40]",0.0005,0.002,0.001,3
4136,0.00011999999999790122,0.35555555555555557,0,5,40,45,39,6,10,16,5,2,0.1,"[0, 20, 40]",0.0005,0.002,0.001,5
4137,-0.003020000000000466,0.3,0,0,10,10,7,3,10,16,5,2,0.1,"[0, 20, 40]",0.0005,0.002,0.0015,1
4138,-0.009190000000002026,0.23333333333333334,0,0,30,30,24,6,10,16,5,2,0.1,"[0, 20, 40]",0.0005,0.002,0.0015,3
4139,-0.010490000000002659,0.24444444444444444,0,0,45,45,39,6,10,16,5,2,0.1,"[0, 20, 40]",0.0005,0.002,0.0015,5
4140,0.003469999999999748,0.6,3,2,5,10,10,0,10,16,5,2,0.2,"[0, 20, 40]",0.0003,0.001,0.001,1
4141,-0.0004700000000012148,0.34615384615384615,3,3,20,26,23,3,10,16,5,2,0.2,"[0, 20, 40]",0.0003,0.001,0.001,3
4142,-0.0020100000000014234,0.2777777777777778,3,4,29,36,32,4,10,16,5,2,0.2,"[0, 20, 40]",0.0003,0.001,0.001,5
4143,0.004469999999999748,0.6,3,2,5,10,10,0,10,16,5,2,0.2,"[0, 20, 40]",0.0003,0.001,0.0015,1
4144,-0.001250000000001218,0.3076923076923077,3,2,21,26,23,3,10,16,5,2,0.2,"[0, 20, 40]",0.0003,0.001,0.0015,3
4145,-0.0027900000000014268,0.25,4,2,30,36,32,4,10,16,5,2,0.2,"[0, 20, 40]",0.0003,0.001,0.0015,5
4146,0.0016799999999996813,0.5,0,2,8,10,10,0,10,16,5,2,0.2,"[0, 20, 40]",0.0003,0.0015,0.001,1
4147,-0.002260000000001282,0.3076923076923077,0,3,23,26,23,3,10,16,5,2,0.2,"[0, 20, 40]",0.0003,0.0015,0.001,3
4148,-0.00380000000000149,0.25,0,4,32,36,32,4,10,16,5,2,0.2,"[0, 20, 40]",0.0003,0.0015,0.001,5
4149,0.002679999999999681,0.5,0,2,8,10,10,0,10,16,5,2,0.2,"[0, 20, 40]",0.0003,0.0015,0.0015,1
4150,-0.0030400000000012847,0.2692307692307692,0,2,24,26,23,3,10,16,5,2,0.2,"[0, 20, 40]",0.0003,0.0015,0.0015,3
4151,-0.004480000000001614,0.2222222222222222,0,2,34,36,32,4,10,16,5,2,0.2,"[0, 20, 40]",0.0003,0.0015,0.0015,5
4152,0.0016799999999996813,0.5,0,2,8,10,10,0,10,16,5,2,0.2,"[0, 20, 40]",0.0003,0.002,0.001,1
4153,-0.002260000000001282,0.3076923076923077,0,3,23,26,23,3,10,16,5,2,0.2,"[0, 20, 40]",0.0003,0.002,0.001,3
4154,-0.00380000000000149,0.25,0,4,32,36,32,4,10,16,5,2,0.2,"[0, 20, 40]",0.0003,0.002,0.001,5
4155,0.002679999999999681,0.5,0,2,8,10,10,0,10,16,5,2,0.2,"[0, 20, 40]",0.0003,0.002,0.0015,1
4156,-0.0030400000000012847,0.2692307692307692,0,2,24,26,23,3,10,16,5,2,0.2,"[0, 20, 40]",0.0003,0.002,0.0015,3
4157,-0.004480000000001614,0.2222222222222222,0,2,34,36,32,4,10,16,5,2,0.2,"[0, 20, 40]",0.0003,0.002,0.0015,5
4158,0.0005699999999997595,0.5,0,1,3,4,4,0,10,16,5,2,0.2,"[0, 20, 40]",0.0005,0.001,0.001,1
4159,0.0014299999999991522,0.4666666666666667,2,3,10,15,14,1,10,16,5,2,0.2,"[0, 20, 40]",0.0005,0.001,0.001,3
4160,0.001099999999998901,0.375,3,3,18,24,23,1,10,16,5,2,0.2,"[0, 20, 40]",0.0005,0.001,0.001,5
4161,-0.0017100000000004108,0.25,0,0,4,4,4,0,10,16,5,2,0.2,"[0, 20, 40]",0.0005,0.001,0.0015,1
4162,-0.0049100000000011895,0.26666666666666666,2,0,13,15,14,1,10,16,5,2,0.2,"[0, 20, 40]",0.0005,0.001,0.0015,3
4163,-0.005240000000001439,0.25,3,0,21,24,23,1,10,16,5,2,0.2,"[0, 20, 40]",0.0005,0.001,0.0015,5
4164,0.0005699999999997595,0.5,0,1,3,4,4,0,10,16,5,2,0.2,"[0, 20, 40]",0.0005,0.0015,0.001,1
4165,0.000789999999998958,0.4,0,3,12,15,14,1,10,16,5,2,0.2,"[0, 20, 40]",0.0005,0.0015,0.001,3
4166,0.0007599999999985633,0.3333333333333333,0,3,21,24,23,1,10,16,5,2,0.2,"[0, 20, 40]",0.0005,0.0015,0.001,5
4167,-0.0017100000000004108,0.25,0,0,4,4,4,0,10,16,5,2,0.2,"[0, 20, 40]",0.0005,0.0015,0.0015,1
4168,-0.005550000000001384,0.2,0,0,15,15,14,1,10,16,5,2,0.2,"[0, 20, 40]",0.0005,0.0015,0.0015,3
4169,-0.005580000000001777,0.20833333333333334,0,0,24,24,23,1,10,16,5,2,0.2,"[0, 20, 40]",0.0005,0.0015,0.0015,5
4170,0.0005699999999997595,0.5,0,1,3,4,4,0,10,16,5,2,0.2,"[0, 20, 40]",0.0005,0.002,0.001,1
4171,0.000789999999998958,0.4,0,3,12,15,14,1,10,16,5,2,0.2,"[0, 20, 40]",0.0005,0.002,0.001,3
4172,0.0007599999999985633,0.3333333333333333,0,3,21,24,23,1,10,16,5,2,0.2,"[0, 20, 40]",0.0005,0.002,0.001,5
4173,-0.0017100000000004108,0.25,0,0,4,4,4,0,10,16,5,2,0.2,"[0, 20, 40]",0.0005,0.002,0.0015,1
4174,-0.005550000000001384,0.2,0,0,15,15,14,1,10,16,5,2,0.2,"[0, 20, 40]",0.0005,0.002,0.0015,3
4175,-0.005580000000001777,0.20833333333333334,0,0,24,24,23,1,10,16,5,2,0.2,"[0, 20, 40]",0.0005,0.002,0.0015,5
4176,0.00935999999999872,0.5294117647058824,8,7,19,34,19,15,10,16,10,1,0.1,"[0, 20, 40]",0.0003,0.001,0.001,1
4177,0.007899999999998348,0.4266666666666667,16,12,47,75,45,30,10,16,10,1,0.1,"[0, 20, 40]",0.0003,0.001,0.001,3
4178,0.012379999999997714,0.4421052631578947,18,16,61,95,63,32,10,16,10,1,0.1,"[0, 20, 40]",0.0003,0.001,0.001,5
4179,0.007419999999998779,0.4411764705882353,8,4,22,34,19,15,10,16,10,1,0.1,"[0, 20, 40]",0.0003,0.001,0.0015,1
4180,0.0040499999999982685,0.36,16,7,52,75,45,30,10,16,10,1,0.1,"[0, 20, 40]",0.0003,0.001,0.0015,3
4181,0.005629999999997575,0.3684210526315789,19,8,68,95,63,32,10,16,10,1,0.1,"[0, 20, 40]",0.0003,0.001,0.0015,5
4182,0.010959999999998762,0.5294117647058824,4,9,21,34,19,15,10,16,10,1,0.1,"[0, 20, 40]",0.0003,0.0015,0.001,1
4183,0.008639999999998095,0.4266666666666667,4,14,57,75,45,30,10,16,10,1,0.1,"[0, 20, 40]",0.0003,0.0015,0.001,3
4184,0.012939999999997167,0.4421052631578947,4,18,73,95,63,32,10,16,10,1,0.1,"[0, 20, 40]",0.0003,0.0015,0.001,5
4185,0.008839999999998693,0.4117647058823529,5,4,25,34,19,15,10,16,10,1,0.1,"[0, 20, 40]",0.0003,0.0015,0.0015,1
4186,0.004609999999997893,0.3466666666666667,5,7,63,75,45,30,10,16,10,1,0.1,"[0, 20, 40]",0.0003,0.0015,0.0015,3
4187,0.006269999999996727,0.35789473684210527,5,8,82,95,63,32,10,16,10,1,0.1,"[0, 20, 40]",0.0003,0.0015,0.0015,5
4188,0.010629999999998604,0.5294117647058824,2,9,23,34,19,15,10,16,10,1,0.1,"[0, 20, 40]",0.0003,0.002,0.001,1
4189,0.008309999999997934,0.4266666666666667,2,14,59,75,45,30,10,16,10,1,0.1,"[0, 20, 40]",0.0003,0.002,0.001,3
4190,0.01260999999999701,0.4421052631578947,2,18,75,95,63,32,10,16,10,1,0.1,"[0, 20, 40]",0.0003,0.002,0.001,5
4191,0.008839999999998531,0.4117647058823529,2,4,28,34,19,15,10,16,10,1,0.1,"[0, 20, 40]",0.0003,0.002,0.0015,1
4192,0.00460999999999773,0.3466666666666667,2,7,66,75,45,30,10,16,10,1,0.1,"[0, 20, 40]",0.0003,0.002,0.0015,3
4193,0.006269999999996562,0.35789473684210527,2,8,85,95,63,32,10,16,10,1,0.1,"[0, 20, 40]",0.0003,0.002,0.0015,5
4194,0.0052399999999999305,0.7777777777777778,3,3,3,9,5,4,10,16,10,1,0.1,"[0, 20, 40]",0.0005,0.001,0.001,1
4195,0.010749999999999673,0.5833333333333334,10,8,18,36,23,13,10,16,10,1,0.1,"[0, 20, 40]",0.0005,0.001,0.001,3
4196,0.014289999999998708,0.5740740740740741,14,10,30,54,40,14,10,16,10,1,0.1,"[0, 20, 40]",0.0005,0.001,0.001,5
4197,0.0025599999999999707,0.5555555555555556,3,1,5,9,5,4,10,16,10,1,0.1,"[0, 20, 40]",0.0005,0.001,0.0015,1
4198,0.0063599999999995604,0.4722222222222222,10,4,22,36,23,13,10,16,10,1,0.1,"[0, 20, 40]",0.0005,0.001,0.0015,3
4199,0.008959999999998365,0.48148148148148145,14,5,35,54,40,14,10,16,10,1,0.1,"[0, 20, 40]",0.0005,0.001,0.0015,5
4200,0.0040099999999997,0.5555555555555556,1,3,5,9,5,4,10,16,10,1,0.1,"[0, 20, 40]",0.0005,0.0015,0.001,1
4201,0.011719999999999313,0.5277777777777778,5,8,23,36,23,13,10,16,10,1,0.1,"[0, 20, 40]",0.0005,0.0015,0.001,3
4202,0.016599999999997908,0.5370370370370371,7,10,37,54,40,14,10,16,10,1,0.1,"[0, 20, 40]",0.0005,0.0015,0.001,5
4203,0.0013299999999997413,0.3333333333333333,1,1,7,9,5,4,10,16,10,1,0.1,"[0, 20, 40]",0.0005,0.0015,0.0015,1
4204,0.0073299999999992,0.4166666666666667,5,4,27,36,23,13,10,16,10,1,0.1,"[0, 20, 40]",0.0005,0.0015,0.0015,3
4205,0.011269999999997567,0.4444444444444444,7,5,42,54,40,14,10,16,10,1,0.1,"[0, 20, 40]",0.0005,0.0015,0.0015,5
4206,0.0045099999999997,0.5555555555555556,1,3,5,9,5,4,10,16,10,1,0.1,"[0, 20, 40]",0.0005,0.002,0.001,1
4207,0.01121999999999898,0.5,3,8,25,36,23,13,10,16,10,1,0.1,"[0, 20, 40]",0.0005,0.002,0.001,3
4208,0.016139999999997507,0.5185185185185185,4,10,40,54,40,14,10,16,10,1,0.1,"[0, 20, 40]",0.0005,0.002,0.001,5
4209,0.0018299999999997413,0.3333333333333333,1,1,7,9,5,4,10,16,10,1,0.1,"[0, 20, 40]",0.0005,0.002,0.0015,1
4210,0.006829999999998867,0.3888888888888889,3,4,29,36,23,13,10,16,10,1,0.1,"[0, 20, 40]",0.0005,0.002,0.0015,3
4211,0.010809999999997164,0.42592592592592593,4,5,45,54,40,14,10,16,10,1,0.1,"[0, 20, 40]",0.0005,0.002,0.0015,5
4212,0.0058299999999996445,0.625,6,2,8,16,13,3,10,16,10,1,0.2,"[0, 20, 40]",0.0003,0.001,0.001,1
4213,0.004509999999999608,0.45454545454545453,8,5,20,33,26,7,10,16,10,1,0.2,"[0, 20, 40]",0.0003,0.001,0.001,3
4214,0.009239999999999266,0.5,9,8,27,44,36,8,10,16,10,1,0.2,"[0, 20, 40]",0.0003,0.001,0.001,5
4215,0.006829999999999645,0.625,6,2,8,16,13,3,10,16,10,1,0.2,"[0, 20, 40]",0.0003,0.001,0.0015,1
4216,0.004349999999999557,0.42424242424242425,8,4,21,33,26,7,10,16,10,1,0.2,"[0, 20, 40]",0.0003,0.001,0.0015,3
4217,0.006179999999999149,0.4318181818181818,9,5,30,44,36,8,10,16,10,1,0.2,"[0, 20, 40]",0.0003,0.001,0.0015,5
4218,0.006929999999999691,0.625,3,3,10,16,13,3,10,16,10,1,0.2,"[0, 20, 40]",0.0003,0.0015,0.001,1
4219,0.00508999999999958,0.45454545454545453,3,6,24,33,26,7,10,16,10,1,0.2,"[0, 20, 40]",0.0003,0.0015,0.001,3
4220,0.009599999999999017,0.5,3,9,32,44,36,8,10,16,10,1,0.2,"[0, 20, 40]",0.0003,0.0015,0.001,5
4221,0.007249999999999567,0.5625,3,2,11,16,13,3,10,16,10,1,0.2,"[0, 20, 40]",0.0003,0.0015,0.0015,1
4222,0.004249999999999405,0.3939393939393939,3,4,26,33,26,7,10,16,10,1,0.2,"[0, 20, 40]",0.0003,0.0015,0.0015,3
4223,0.005859999999998776,0.4090909090909091,3,5,36,44,36,8,10,16,10,1,0.2,"[0, 20, 40]",0.0003,0.0015,0.0015,5
4224,0.006099999999999527,0.625,1,3,12,16,13,3,10,16,10,1,0.2,"[0, 20, 40]",0.0003,0.002,0.001,1
4225,0.004259999999999416,0.45454545454545453,1,6,26,33,26,7,10,16,10,1,0.2,"[0, 20, 40]",0.0003,0.002,0.001,3
4226,0.008769999999998862,0.5,1,9,34,44,36,8,10,16,10,1,0.2,"[0, 20, 40]",0.0003,0.002,0.001,5
4227,0.006419999999999406,0.5625,1,2,13,16,13,3,10,16,10,1,0.2,"[0, 20, 40]",0.0003,0.002,0.0015,1
4228,0.0034199999999992435,0.3939393939393939,1,4,28,33,26,7,10,16,10,1,0.2,"[0, 20, 40]",0.0003,0.002,0.0015,3
4229,0.005029999999998611,0.4090909090909091,1,5,38,44,36,8,10,16,10,1,0.2,"[0, 20, 40]",0.0003,0.002,0.0015,5
4230,0.002759999999999872,0.8,2,1,2,5,4,1,10,16,10,1,0.2,"[0, 20, 40]",0.0005,0.001,0.001,1
4231,0.0048099999999998665,0.6,5,4,11,20,17,3,10,16,10,1,0.2,"[0, 20, 40]",0.0005,0.001,0.001,3
4232,0.006909999999999303,0.6,6,6,18,30,27,3,10,16,10,1,0.2,"[0, 20, 40]",0.0005,0.001,0.001,5
4233,0.0032599999999998715,0.8,2,1,2,5,4,1,10,16,10,1,0.2,"[0, 20, 40]",0.0005,0.001,0.0015,1
4234,0.004309999999999754,0.55,5,3,12,20,17,3,10,16,10,1,0.2,"[0, 20, 40]",0.0005,0.001,0.0015,3
4235,0.0054699999999989705,0.5333333333333333,6,4,20,30,27,3,10,16,10,1,0.2,"[0, 20, 40]",0.0005,0.001,0.0015,5
4236,0.002639999999999697,0.6,1,1,3,5,4,1,10,16,10,1,0.2,"[0, 20, 40]",0.0005,0.0015,0.001,1
4237,0.005149999999999652,0.55,2,4,14,20,17,3,10,16,10,1,0.2,"[0, 20, 40]",0.0005,0.0015,0.001,3
4238,0.0071299999999988595,0.5666666666666667,2,6,22,30,27,3,10,16,10,1,0.2,"[0, 20, 40]",0.0005,0.0015,0.001,5
4239,0.0031399999999996964,0.6,1,1,3,5,4,1,10,16,10,1,0.2,"[0, 20, 40]",0.0005,0.0015,0.0015,1
4240,0.00464999999999954,0.5,2,3,15,20,17,3,10,16,10,1,0.2,"[0, 20, 40]",0.0005,0.0015,0.0015,3
4241,0.005689999999998528,0.5,2,4,24,30,27,3,10,16,10,1,0.2,"[0, 20, 40]",0.0005,0.0015,0.0015,5
4242,0.003139999999999697,0.6,1,1,3,5,4,1,10,16,10,1,0.2,"[0, 20, 40]",0.0005,0.002,0.001,1
4243,0.004469999999999528,0.5,1,4,15,20,17,3,10,16,10,1,0.2,"[0, 20, 40]",0.0005,0.002,0.001,3
4244,0.006449999999998733,0.5333333333333333,1,6,23,30,27,3,10,16,10,1,0.2,"[0, 20, 40]",0.0005,0.002,0.001,5
4245,0.0036399999999996964,0.6,1,1,3,5,4,1,10,16,10,1,0.2,"[0, 20, 40]",0.0005,0.002,0.0015,1
4246,0.003969999999999415,0.45,1,3,16,20,17,3,10,16,10,1,0.2,"[0, 20, 40]",0.0005,0.002,0.0015,3
4247,0.005009999999998404,0.4666666666666667,1,4,25,30,27,3,10,16,10,1,0.2,"[0, 20, 40]",0.0005,0.002,0.0015,5
4248,0.004079999999998881,0.4166666666666667,4,4,16,24,16,8,10,16,10,2,0.1,"[0, 20, 40]",0.0003,0.001,0.001,1
4249,0.0046599999999981006,0.38333333333333336,11,9,40,60,43,17,10,16,10,2,0.1,"[0, 20, 40]",0.0003,0.001,0.001,3
4250,0.009919999999997549,0.42857142857142855,13,13,51,77,59,18,10,16,10,2,0.1,"[0, 20, 40]",0.0003,0.001,0.001,5
4251,0.004659999999998961,0.375,4,3,17,24,16,8,10,16,10,2,0.1,"[0, 20, 40]",0.0003,0.001,0.0015,1
4252,0.005079999999998133,0.35,11,7,42,60,43,17,10,16,10,2,0.1,"[0, 20, 40]",0.0003,0.001,0.0015,3
4253,0.007439999999997509,0.37662337662337664,14,8,55,77,59,18,10,16,10,2,0.1,"[0, 20, 40]",0.0003,0.001,0.0015,5
4254,0.004529999999998943,0.4166666666666667,2,5,17,24,16,8,10,16,10,2,0.1,"[0, 20, 40]",0.0003,0.0015,0.001,1
4255,0.0046199999999979565,0.38333333333333336,2,10,48,60,43,17,10,16,10,2,0.1,"[0, 20, 40]",0.0003,0.0015,0.001,3
4256,0.00969999999999711,0.42857142857142855,2,14,61,77,59,18,10,16,10,2,0.1,"[0, 20, 40]",0.0003,0.0015,0.001,5
4257,0.004429999999998898,0.3333333333333333,2,3,19,24,16,8,10,16,10,2,0.1,"[0, 20, 40]",0.0003,0.0015,0.0015,1
4258,0.004359999999997864,0.3333333333333333,2,7,51,60,43,17,10,16,10,2,0.1,"[0, 20, 40]",0.0003,0.0015,0.0015,3
4259,0.006799999999996765,0.36363636363636365,2,8,67,77,59,18,10,16,10,2,0.1,"[0, 20, 40]",0.0003,0.0015,0.0015,5
4260,0.004969999999999051,0.4166666666666667,1,5,18,24,16,8,10,16,10,2,0.1,"[0, 20, 40]",0.0003,0.002,0.001,1
4261,0.005059999999998065,0.38333333333333336,1,10,49,60,43,17,10,16,10,2,0.1,"[0, 20, 40]",0.0003,0.002,0.001,3
4262,0.010139999999997219,0.42857142857142855,1,14,62,77,59,18,10,16,10,2,0.1,"[0, 20, 40]",0.0003,0.002,0.001,5
4263,0.004869999999999006,0.3333333333333333,1,3,20,24,16,8,10,16,10,2,0.1,"[0, 20, 40]",0.0003,0.002,0.0015,1
4264,0.004799999999997971,0.3333333333333333,1,7,52,60,43,17,10,16,10,2,0.1,"[0, 20, 40]",0.0003,0.002,0.0015,3
4265,0.007239999999996874,0.36363636363636365,1,8,68,77,59,18,10,16,10,2,0.1,"[0, 20, 40]",0.0003,0.002,0.0015,5
4266,0.003609999999999999,0.6,3,2,5,10,7,3,10,16,10,2,0.1,"[0, 20, 40]",0.0005,0.001,0.001,1
4267,0.00928999999999968,0.5666666666666667,8,7,15,30,24,6,10,16,10,2,0.1,"[0, 20, 40]",0.0005,0.001,0.001,3
4268,0.013399999999998939,0.5652173913043478,12,9,25,46,40,6,10,16,10,2,0.1,"[0, 20, 40]",0.0005,0.001,0.001,5
4269,0.0018099999999999202,0.5,3,1,6,10,7,3,10,16,10,2,0.1,"[0, 20, 40]",0.0005,0.001,0.0015,1
4270,0.007489999999999488,0.5,8,5,17,30,24,6,10,16,10,2,0.1,"[0, 20, 40]",0.0005,0.001,0.0015,3
4271,0.010659999999998525,0.5,12,6,28,46,40,6,10,16,10,2,0.1,"[0, 20, 40]",0.0005,0.001,0.0015,5
4272,0.0023799999999997695,0.4,1,2,7,10,7,3,10,16,10,2,0.1,"[0, 20, 40]",0.0005,0.0015,0.001,1
4273,0.009259999999999323,0.5,3,7,20,30,24,6,10,16,10,2,0.1,"[0, 20, 40]",0.0005,0.0015,0.001,3
4274,0.01470999999999814,0.5217391304347826,5,9,32,46,40,6,10,16,10,2,0.1,"[0, 20, 40]",0.0005,0.0015,0.001,5
4275,0.0005799999999996909,0.3,1,1,8,10,7,3,10,16,10,2,0.1,"[0, 20, 40]",0.0005,0.0015,0.0015,1
4276,0.0074599999999991305,0.43333333333333335,3,5,22,30,24,6,10,16,10,2,0.1,"[0, 20, 40]",0.0005,0.0015,0.0015,3
4277,0.011969999999997727,0.45652173913043476,5,6,35,46,40,6,10,16,10,2,0.1,"[0, 20, 40]",0.0005,0.0015,0.0015,5
4278,0.0028799999999997695,0.4,1,2,7,10,7,3,10,16,10,2,0.1,"[0, 20, 40]",0.0005,0.002,0.001,1
4279,0.009439999999999114,0.5,2,7,21,30,24,6,10,16,10,2,0.1,"[0, 20, 40]",0.0005,0.002,0.001,3
4280,0.01492999999999786,0.5217391304347826,3,9,34,46,40,6,10,16,10,2,0.1,"[0, 20, 40]",0.0005,0.002,0.001,5
4281,0.001079999999999691,0.3,1,1,8,10,7,3,10,16,10,2,0.1,"[0, 20, 40]",0.0005,0.002,0.0015,1
4282,0.007639999999998923,0.43333333333333335,2,5,23,30,24,6,10,16,10,2,0.1,"[0, 20, 40]",0.0005,0.002,0.0015,3
4283,0.012189999999997444,0.45652173913043476,3,6,37,46,40,6,10,16,10,2,0.1,"[0, 20, 40]",0.0005,0.002,0.0015,5
4284,0.0032999999999997445,0.6,3,2,5,10,10,0,10,16,10,2,0.2,"[0, 20, 40]",0.0003,0.001,0.001,1
4285,0.002359999999999558,0.4230769230769231,5,5,16,26,23,3,10,16,10,2,0.2,"[0, 20, 40]",0.0003,0.001,0.001,3
4286,0.007329999999999013,0.5135135135135135,5,9,23,37,33,4,10,16,10,2,0.2,"[0, 20, 40]",0.0003,0.001,0.001,5
4287,0.004299999999999744,0.6,3,2,5,10,10,0,10,16,10,2,0.2,"[0, 20, 40]",0.0003,0.001,0.0015,1
4288,0.0021999999999995075,0.38461538461538464,5,4,17,26,23,3,10,16,10,2,0.2,"[0, 20, 40]",0.0003,0.001,0.0015,3
4289,0.004269999999998889,0.43243243243243246,6,5,26,37,33,4,10,16,10,2,0.2,"[0, 20, 40]",0.0003,0.001,0.0015,5
4290,0.003249999999999806,0.6,1,3,6,10,10,0,10,16,10,2,0.2,"[0, 20, 40]",0.0003,0.0015,0.001,1
4291,0.0024399999999995844,0.4230769230769231,1,6,19,26,23,3,10,16,10,2,0.2,"[0, 20, 40]",0.0003,0.0015,0.001,3
4292,0.007409999999999038,0.5135135135135135,1,10,26,37,33,4,10,16,10,2,0.2,"[0, 20, 40]",0.0003,0.0015,0.001,5
4293,0.003569999999999682,0.5,1,2,7,10,10,0,10,16,10,2,0.2,"[0, 20, 40]",0.0003,0.0015,0.0015,1
4294,0.0015999999999994096,0.34615384615384615,1,4,21,26,23,3,10,16,10,2,0.2,"[0, 20, 40]",0.0003,0.0015,0.0015,3
4295,0.003929999999998609,0.40540540540540543,1,5,31,37,33,4,10,16,10,2,0.2,"[0, 20, 40]",0.0003,0.0015,0.0015,5
4296,0.003189999999999914,0.6,0,3,7,10,10,0,10,16,10,2,0.2,"[0, 20, 40]",0.0003,0.002,0.001,1
4297,0.0023799999999996923,0.4230769230769231,0,6,20,26,23,3,10,16,10,2,0.2,"[0, 20, 40]",0.0003,0.002,0.001,3
4298,0.007349999999999146,0.5135135135135135,0,10,27,37,33,4,10,16,10,2,0.2,"[0, 20, 40]",0.0003,0.002,0.001,5
4299,0.0035099999999997893,0.5,0,2,8,10,10,0,10,16,10,2,0.2,"[0, 20, 40]",0.0003,0.002,0.0015,1
4300,0.0015399999999995174,0.34615384615384615,0,4,22,26,23,3,10,16,10,2,0.2,"[0, 20, 40]",0.0003,0.002,0.0015,3
4301,0.0038699999999987165,0.40540540540540543,0,5,32,37,33,4,10,16,10,2,0.2,"[0, 20, 40]",0.0003,0.002,0.0015,5
4302,0.0006499999999998396,0.5,0,1,3,4,4,0,10,16,10,2,0.2,"[0, 20, 40]",0.0005,0.001,0.001,1
4303,0.001989999999999822,0.4666666666666667,2,4,9,15,14,1,10,16,10,2,0.2,"[0, 20, 40]",0.0005,0.001,0.001,3
4304,0.0045699999999994035,0.52,4,6,15,25,24,1,10,16,10,2,0.2,"[0, 20, 40]",0.0005,0.001,0.001,5
4305,0.001149999999999839,0.5,0,1,3,4,4,0,10,16,10,2,0.2,"[0, 20, 40]",0.0005,0.001,0.0015,1
4306,0.00148999999999971,0.4,2,3,10,15,14,1,10,16,10,2,0.2,"[0, 20, 40]",0.0005,0.001,0.0015,3
4307,0.003129999999999073,0.44,4,4,17,25,24,1,10,16,10,2,0.2,"[0, 20, 40]",0.0005,0.001,0.0015,5
4308,0.0006499999999998396,0.5,0,1,3,4,4,0,10,16,10,2,0.2,"[0, 20, 40]",0.0005,0.0015,0.001,1
4309,0.0024499999999996716,0.4666666666666667,1,4,10,15,14,1,10,16,10,2,0.2,"[0, 20, 40]",0.0005,0.0015,0.001,3
4310,0.005369999999998819,0.52,1,6,18,25,24,1,10,16,10,2,0.2,"[0, 20, 40]",0.0005,0.0015,0.001,5
4311,0.001149999999999839,0.5,0,1,3,4,4,0,10,16,10,2,0.2,"[0, 20, 40]",0.0005,0.0015,0.0015,1
4312,0.0019499999999995597,0.4,1,3,11,15,14,1,10,16,10,2,0.2,"[0, 20, 40]",0.0005,0.0015,0.0015,3
4313,0.003929999999998488,0.44,1,4,20,25,24,1,10,16,10,2,0.2,"[0, 20, 40]",0.0005,0.0015,0.0015,5
4314,0.0006499999999998396,0.5,0,1,3,4,4,0,10,16,10,2,0.2,"[0, 20, 40]",0.0005,0.002,0.001,1
4315,0.0029499999999996716,0.4666666666666667,1,4,10,15,14,1,10,16,10,2,0.2,"[0, 20, 40]",0.0005,0.002,0.001,3
4316,0.00586999999999882,0.52,1,6,18,25,24,1,10,16,10,2,0.2,"[0, 20, 40]",0.0005,0.002,0.001,5
4317,0.001149999999999839,0.5,0,1,3,4,4,0,10,16,10,2,0.2,"[0, 20, 40]",0.0005,0.002,0.0015,1
4318,0.002449999999999559,0.4,1,3,11,15,14,1,10,16,10,2,0.2,"[0, 20, 40]",0.0005,0.002,0.0015,3
4319,0.004429999999998486,0.44,1,4,20,25,24,1,10,16,10,2,0.2,"[0, 20, 40]",0.0005,0.002,0.0015,5
4320,0.010189999999998872,0.625,8,9,15,32,17,15,10,16,15,1,0.1,"[0, 20, 40]",0.0003,0.001,0.001,1
4321,0.019959999999997907,0.5833333333333334,17,19,36,72,42,30,10,16,15,1,0.1,"[0, 20, 40]",0.0003,0.001,0.001,3
4322,0.026179999999997348,0.5760869565217391,21,23,48,92,60,32,10,16,15,1,0.1,"[0, 20, 40]",0.0003,0.001,0.001,5
4323,0.00361999999999874,0.5,9,3,20,32,17,15,10,16,15,1,0.1,"[0, 20, 40]",0.0003,0.001,0.0015,1
4324,0.009969999999997474,0.4722222222222222,18,9,45,72,42,30,10,16,15,1,0.1,"[0, 20, 40]",0.0003,0.001,0.0015,3
4325,0.015029999999997086,0.4782608695652174,23,11,58,92,60,32,10,16,15,1,0.1,"[0, 20, 40]",0.0003,0.001,0.0015,5
4326,0.012669999999998852,0.625,5,11,16,32,17,15,10,16,15,1,0.1,"[0, 20, 40]",0.0003,0.0015,0.001,1
4327,0.02295999999999763,0.5694444444444444,9,21,42,72,42,30,10,16,15,1,0.1,"[0, 20, 40]",0.0003,0.0015,0.001,3
4328,0.02925999999999695,0.5652173913043478,9,25,58,92,60,32,10,16,15,1,0.1,"[0, 20, 40]",0.0003,0.0015,0.001,5
4329,0.007099999999998611,0.5,7,3,22,32,17,15,10,16,15,1,0.1,"[0, 20, 40]",0.0003,0.0015,0.0015,1
4330,0.013969999999997082,0.4583333333333333,11,9,52,72,42,30,10,16,15,1,0.1,"[0, 20, 40]",0.0003,0.0015,0.0015,3
4331,0.01960999999999659,0.4673913043478261,12,11,69,92,60,32,10,16,15,1,0.1,"[0, 20, 40]",0.0003,0.0015,0.0015,5
4332,0.012699999999998884,0.59375,3,11,18,32,17,15,10,16,15,1,0.1,"[0, 20, 40]",0.0003,0.002,0.001,1
4333,0.024379999999997667,0.5555555555555556,6,21,45,72,42,30,10,16,15,1,0.1,"[0, 20, 40]",0.0003,0.002,0.001,3
4334,0.030679999999996994,0.5543478260869565,6,25,61,92,60,32,10,16,15,1,0.1,"[0, 20, 40]",0.0003,0.002,0.001,5
4335,0.007549999999998842,0.46875,3,3,26,32,17,15,10,16,15,1,0.1,"[0, 20, 40]",0.0003,0.002,0.0015,1
4336,0.015809999999997316,0.4444444444444444,6,9,57,72,42,30,10,16,15,1,0.1,"[0, 20, 40]",0.0003,0.002,0.0015,3
4337,0.02194999999999683,0.45652173913043476,7,11,74,92,60,32,10,16,15,1,0.1,"[0, 20, 40]",0.0003,0.002,0.0015,5
4338,0.005549999999999874,0.875,5,2,1,8,4,4,10,16,15,1,0.1,"[0, 20, 40]",0.0005,0.001,0.001,1
4339,0.017769999999999272,0.7714285714285715,13,11,11,35,22,13,10,16,15,1,0.1,"[0, 20, 40]",0.0005,0.001,0.001,3
4340,0.02129999999999857,0.6792452830188679,18,13,22,53,39,14,10,16,15,1,0.1,"[0, 20, 40]",0.0005,0.001,0.001,5
4341,0.0032499999999997934,0.75,6,0,2,8,4,4,10,16,15,1,0.1,"[0, 20, 40]",0.0005,0.001,0.0015,1
4342,0.010769999999999105,0.6285714285714286,14,5,16,35,22,13,10,16,15,1,0.1,"[0, 20, 40]",0.0005,0.001,0.0015,3
4343,0.0152999999999984,0.5849056603773585,19,7,27,53,39,14,10,16,15,1,0.1,"[0, 20, 40]",0.0005,0.001,0.0015,5
4344,0.0032099999999997005,0.625,1,2,5,8,4,4,10,16,15,1,0.1,"[0, 20, 40]",0.0005,0.0015,0.001,1
4345,0.017819999999998934,0.7142857142857143,6,11,18,35,22,13,10,16,15,1,0.1,"[0, 20, 40]",0.0005,0.0015,0.001,3
4346,0.023509999999998064,0.6415094339622641,10,13,30,53,39,14,10,16,15,1,0.1,"[0, 20, 40]",0.0005,0.0015,0.001,5
4347,0.0014099999999996212,0.5,2,0,6,8,4,4,10,16,15,1,0.1,"[0, 20, 40]",0.0005,0.0015,0.0015,1
4348,0.011319999999998767,0.5714285714285714,7,5,23,35,22,13,10,16,15,1,0.1,"[0, 20, 40]",0.0005,0.0015,0.0015,3
4349,0.018009999999997892,0.5471698113207547,11,7,35,53,39,14,10,16,15,1,0.1,"[0, 20, 40]",0.0005,0.0015,0.0015,5
4350,0.0037099999999997005,0.625,1,2,5,8,4,4,10,16,15,1,0.1,"[0, 20, 40]",0.0005,0.002,0.001,1
4351,0.01908999999999893,0.7142857142857143,4,11,20,35,22,13,10,16,15,1,0.1,"[0, 20, 40]",0.0005,0.002,0.001,3
4352,0.024119999999997952,0.6226415094339622,6,13,34,53,39,14,10,16,15,1,0.1,"[0, 20, 40]",0.0005,0.002,0.001,5
4353,0.002409999999999621,0.5,2,0,6,8,4,4,10,16,15,1,0.1,"[0, 20, 40]",0.0005,0.002,0.0015,1
4354,0.013089999999998759,0.5714285714285714,5,5,25,35,22,13,10,16,15,1,0.1,"[0, 20, 40]",0.0005,0.002,0.0015,3
4355,0.019119999999997788,0.5283018867924528,7,7,39,53,39,14,10,16,15,1,0.1,"[0, 20, 40]",0.0005,0.002,0.0015,5
4356,0.004419999999999443,0.6428571428571429,5,2,7,14,11,3,10,16,15,1,0.2,"[0, 20, 40]",0.0003,0.001,0.001,1
4357,0.005759999999998629,0.5161290322580645,7,5,19,31,24,7,10,16,15,1,0.2,"[0, 20, 40]",0.0003,0.001,0.001,3
4358,0.010909999999998596,0.5476190476190477,10,8,24,42,34,8,10,16,15,1,0.2,"[0, 20, 40]",0.0003,0.001,0.001,5
4359,0.0025799999999995453,0.5714285714285714,5,1,8,14,11,3,10,16,15,1,0.2,"[0, 20, 40]",0.0003,0.001,0.0015,1
4360,0.0034099999999984954,0.45161290322580644,7,3,21,31,24,7,10,16,15,1,0.2,"[0, 20, 40]",0.0003,0.001,0.0015,3
4361,0.007399999999998636,0.47619047619047616,10,5,27,42,34,8,10,16,15,1,0.2,"[0, 20, 40]",0.0003,0.001,0.0015,5
4362,0.0064199999999994435,0.6428571428571429,4,3,7,14,11,3,10,16,15,1,0.2,"[0, 20, 40]",0.0003,0.0015,0.001,1
4363,0.007979999999998523,0.5161290322580645,4,6,21,31,24,7,10,16,15,1,0.2,"[0, 20, 40]",0.0003,0.0015,0.001,3
4364,0.013269999999998396,0.5476190476190477,4,9,29,42,34,8,10,16,15,1,0.2,"[0, 20, 40]",0.0003,0.0015,0.001,5
4365,0.004579999999999437,0.5714285714285714,4,1,9,14,11,3,10,16,15,1,0.2,"[0, 20, 40]",0.0003,0.0015,0.0015,1
4366,0.005629999999998279,0.45161290322580644,4,3,24,31,24,7,10,16,15,1,0.2,"[0, 20, 40]",0.0003,0.0015,0.0015,3
4367,0.00975999999999833,0.47619047619047616,4,5,33,42,34,8,10,16,15,1,0.2,"[0, 20, 40]",0.0003,0.0015,0.0015,5
4368,0.005949999999999475,0.5714285714285714,2,3,9,14,11,3,10,16,15,1,0.2,"[0, 20, 40]",0.0003,0.002,0.001,1
4369,0.007509999999998554,0.4838709677419355,2,6,23,31,24,7,10,16,15,1,0.2,"[0, 20, 40]",0.0003,0.002,0.001,3
4370,0.012799999999998425,0.5238095238095238,2,9,31,42,34,8,10,16,15,1,0.2,"[0, 20, 40]",0.0003,0.002,0.001,5
4371,0.004109999999999467,0.5,2,1,11,14,11,3,10,16,15,1,0.2,"[0, 20, 40]",0.0003,0.002,0.0015,1
4372,0.005159999999998309,0.41935483870967744,2,3,26,31,24,7,10,16,15,1,0.2,"[0, 20, 40]",0.0003,0.002,0.0015,3
4373,0.009289999999998367,0.4523809523809524,2,5,35,42,34,8,10,16,15,1,0.2,"[0, 20, 40]",0.0003,0.002,0.0015,5
4374,0.0023499999999998726,0.75,3,0,1,4,3,1,10,16,15,1,0.2,"[0, 20, 40]",0.0005,0.001,0.001,1
4375,0.00793999999999952,0.6842105263157895,6,5,8,19,16,3,10,16,15,1,0.2,"[0, 20, 40]",0.0005,0.001,0.001,3
4376,0.009689999999998993,0.5862068965517241,8,7,14,29,26,3,10,16,15,1,0.2,"[0, 20, 40]",0.0005,0.001,0.001,5
4377,0.0023499999999998726,0.75,3,0,1,4,3,1,10,16,15,1,0.2,"[0, 20, 40]",0.0005,0.001,0.0015,1
4378,0.006159999999999351,0.5789473684210527,6,3,10,19,16,3,10,16,15,1,0.2,"[0, 20, 40]",0.0005,0.001,0.0015,3
4379,0.00890999999999882,0.5172413793103449,8,5,16,29,26,3,10,16,15,1,0.2,"[0, 20, 40]",0.0005,0.001,0.0015,5
4380,0.001099999999999512,0.5,1,0,3,4,3,1,10,16,15,1,0.2,"[0, 20, 40]",0.0005,0.0015,0.001,1
4381,0.007939999999999134,0.631578947368421,3,5,11,19,16,3,10,16,15,1,0.2,"[0, 20, 40]",0.0005,0.0015,0.001,3
4382,0.010349999999998432,0.5517241379310345,4,7,18,29,26,3,10,16,15,1,0.2,"[0, 20, 40]",0.0005,0.0015,0.001,5
4383,0.001099999999999512,0.5,1,0,3,4,3,1,10,16,15,1,0.2,"[0, 20, 40]",0.0005,0.0015,0.0015,1
4384,0.0061599999999989614,0.5263157894736842,3,3,13,19,16,3,10,16,15,1,0.2,"[0, 20, 40]",0.0005,0.0015,0.0015,3
4385,0.00956999999999826,0.4827586206896552,4,5,20,29,26,3,10,16,15,1,0.2,"[0, 20, 40]",0.0005,0.0015,0.0015,5
4386,0.001599999999999512,0.5,1,0,3,4,3,1,10,16,15,1,0.2,"[0, 20, 40]",0.0005,0.002,0.001,1
4387,0.0077099999999991255,0.631578947368421,1,5,13,19,16,3,10,16,15,1,0.2,"[0, 20, 40]",0.0005,0.002,0.001,3
4388,0.009799999999998388,0.5517241379310345,1,7,21,29,26,3,10,16,15,1,0.2,"[0, 20, 40]",0.0005,0.002,0.001,5
4389,0.001599999999999512,0.5,1,0,3,4,3,1,10,16,15,1,0.2,"[0, 20, 40]",0.0005,0.002,0.0015,1
4390,0.0059299999999989535,0.5263157894736842,1,3,15,19,16,3,10,16,15,1,0.2,"[0, 20, 40]",0.0005,0.002,0.0015,3
4391,0.009019999999998215,0.4827586206896552,1,5,23,29,26,3,10,16,15,1,0.2,"[0, 20, 40]",0.0005,0.002,0.0015,5
4392,0.0009199999999992079,0.4090909090909091,4,3,15,22,14,8,10,16,15,2,0.1,"[0, 20, 40]",0.0003,0.001,0.001,1
4393,0.007599999999998449,0.47368421052631576,12,11,34,57,40,17,10,16,15,2,0.1,"[0, 20, 40]",0.0003,0.001,0.001,3
4394,0.01385999999999822,0.5,16,15,43,74,56,18,10,16,15,2,0.1,"[0, 20, 40]",0.0003,0.001,0.001,5
4395,0.0013399999999992949,0.4090909090909091,4,2,16,22,14,8,10,16,15,2,0.1,"[0, 20, 40]",0.0003,0.001,0.0015,1
4396,0.007579999999998201,0.43859649122807015,12,8,37,57,40,17,10,16,15,2,0.1,"[0, 20, 40]",0.0003,0.001,0.0015,3
4397,0.012679999999998139,0.4594594594594595,17,10,47,74,56,18,10,16,15,2,0.1,"[0, 20, 40]",0.0003,0.001,0.0015,5
4398,0.0018999999999991884,0.4090909090909091,2,4,16,22,14,8,10,16,15,2,0.1,"[0, 20, 40]",0.0003,0.0015,0.001,1
4399,0.009679999999998088,0.45614035087719296,6,12,39,57,40,17,10,16,15,2,0.1,"[0, 20, 40]",0.0003,0.0015,0.001,3
4400,0.016019999999997713,0.4864864864864865,6,16,52,74,56,18,10,16,15,2,0.1,"[0, 20, 40]",0.0003,0.0015,0.001,5
4401,0.002319999999999165,0.4090909090909091,2,2,18,22,14,8,10,16,15,2,0.1,"[0, 20, 40]",0.0003,0.0015,0.0015,1
4402,0.00965999999999773,0.42105263157894735,6,8,43,57,40,17,10,16,15,2,0.1,"[0, 20, 40]",0.0003,0.0015,0.0015,3
4403,0.015339999999997524,0.44594594594594594,7,10,57,74,56,18,10,16,15,2,0.1,"[0, 20, 40]",0.0003,0.0015,0.0015,5
4404,0.0028999999999991884,0.4090909090909091,2,4,16,22,14,8,10,16,15,2,0.1,"[0, 20, 40]",0.0003,0.002,0.001,1
4405,0.012069999999998086,0.45614035087719296,5,12,40,57,40,17,10,16,15,2,0.1,"[0, 20, 40]",0.0003,0.002,0.001,3
4406,0.018409999999997716,0.4864864864864865,5,16,53,74,56,18,10,16,15,2,0.1,"[0, 20, 40]",0.0003,0.002,0.001,5
4407,0.003319999999999165,0.4090909090909091,2,2,18,22,14,8,10,16,15,2,0.1,"[0, 20, 40]",0.0003,0.002,0.0015,1
4408,0.012049999999997727,0.42105263157894735,5,8,44,57,40,17,10,16,15,2,0.1,"[0, 20, 40]",0.0003,0.002,0.0015,3
4409,0.018229999999997533,0.44594594594594594,6,10,58,74,56,18,10,16,15,2,0.1,"[0, 20, 40]",0.0003,0.002,0.0015,5
4410,0.004359999999999938,0.6666666666666666,5,1,3,9,6,3,10,16,15,2,0.1,"[0, 20, 40]",0.0005,0.001,0.001,1
4411,0.014129999999999435,0.7241379310344828,11,8,10,29,23,6,10,16,15,2,0.1,"[0, 20, 40]",0.0005,0.001,0.001,3
4412,0.018849999999998805,0.6666666666666666,16,10,19,45,39,6,10,16,15,2,0.1,"[0, 20, 40]",0.0005,0.001,0.001,5
4413,0.0020599999999998593,0.5555555555555556,5,0,4,9,6,3,10,16,15,2,0.1,"[0, 20, 40]",0.0005,0.001,0.0015,1
4414,0.010639999999999164,0.6206896551724138,11,5,13,29,23,6,10,16,15,2,0.1,"[0, 20, 40]",0.0005,0.001,0.0015,3
4415,0.01635999999999853,0.6,16,7,22,45,39,6,10,16,15,2,0.1,"[0, 20, 40]",0.0005,0.001,0.0015,5
4416,0.002019999999999766,0.4444444444444444,1,1,7,9,6,3,10,16,15,2,0.1,"[0, 20, 40]",0.0005,0.0015,0.001,1
4417,0.013179999999999097,0.6551724137931034,4,8,17,29,23,6,10,16,15,2,0.1,"[0, 20, 40]",0.0005,0.0015,0.001,3
4418,0.020059999999998294,0.6222222222222222,8,10,27,45,39,6,10,16,15,2,0.1,"[0, 20, 40]",0.0005,0.0015,0.001,5
4419,-0.0002800000000003134,0.3333333333333333,1,0,8,9,6,3,10,16,15,2,0.1,"[0, 20, 40]",0.0005,0.0015,0.0015,1
4420,0.00968999999999883,0.5517241379310345,4,5,20,29,23,6,10,16,15,2,0.1,"[0, 20, 40]",0.0005,0.0015,0.0015,3
4421,0.017569999999998014,0.5555555555555556,8,7,30,45,39,6,10,16,15,2,0.1,"[0, 20, 40]",0.0005,0.0015,0.0015,5
4422,0.002519999999999766,0.4444444444444444,1,1,7,9,6,3,10,16,15,2,0.1,"[0, 20, 40]",0.0005,0.002,0.001,1
4423,0.014579999999999161,0.6551724137931034,3,8,18,29,23,6,10,16,15,2,0.1,"[0, 20, 40]",0.0005,0.002,0.001,3
4424,0.020799999999998257,0.6,5,10,30,45,39,6,10,16,15,2,0.1,"[0, 20, 40]",0.0005,0.002,0.001,5
4425,0.0002199999999996866,0.3333333333333333,1,0,8,9,6,3,10,16,15,2,0.1,"[0, 20, 40]",0.0005,0.002,0.0015,1
4426,0.011089999999998894,0.5517241379310345,3,5,21,29,23,6,10,16,15,2,0.1,"[0, 20, 40]",0.0005,0.002,0.0015,3
4427,0.018309999999997984,0.5333333333333333,5,7,33,45,39,6,10,16,15,2,0.1,"[0, 20, 40]",0.0005,0.002,0.0015,5
4428,0.0014399999999998182,0.5,2,1,5,8,8,0,10,16,15,2,0.2,"[0, 20, 40]",0.0003,0.001,0.001,1
4429,0.004369999999999446,0.5,4,6,14,24,21,3,10,16,15,2,0.2,"[0, 20, 40]",0.0003,0.001,0.001,3
4430,0.010179999999999297,0.5714285714285714,6,10,19,35,31,4,10,16,15,2,0.2,"[0, 20, 40]",0.0003,0.001,0.001,5
4431,0.0019399999999998177,0.5,2,1,5,8,8,0,10,16,15,2,0.2,"[0, 20, 40]",0.0003,0.001,0.0015,1
4432,0.002929999999999117,0.4166666666666667,4,4,16,24,21,3,10,16,15,2,0.2,"[0, 20, 40]",0.0003,0.001,0.0015,3
4433,0.007579999999999137,0.4857142857142857,7,6,22,35,31,4,10,16,15,2,0.2,"[0, 20, 40]",0.0003,0.001,0.0015,5
4434,0.0019399999999998182,0.5,1,2,5,8,8,0,10,16,15,2,0.2,"[0, 20, 40]",0.0003,0.0015,0.001,1
4435,0.0043499999999993145,0.4583333333333333,2,7,15,24,21,3,10,16,15,2,0.2,"[0, 20, 40]",0.0003,0.0015,0.001,3
4436,0.01031999999999933,0.5428571428571428,2,11,22,35,31,4,10,16,15,2,0.2,"[0, 20, 40]",0.0003,0.0015,0.001,5
4437,0.002439999999999707,0.5,1,1,6,8,8,0,10,16,15,2,0.2,"[0, 20, 40]",0.0003,0.0015,0.0015,1
4438,0.0029099999999988757,0.375,2,4,18,24,21,3,10,16,15,2,0.2,"[0, 20, 40]",0.0003,0.0015,0.0015,3
4439,0.008219999999999056,0.45714285714285713,3,6,26,35,31,4,10,16,15,2,0.2,"[0, 20, 40]",0.0003,0.0015,0.0015,5
4440,0.0024399999999998177,0.5,1,2,5,8,8,0,10,16,15,2,0.2,"[0, 20, 40]",0.0003,0.002,0.001,1
4441,0.005349999999999316,0.4583333333333333,2,7,15,24,21,3,10,16,15,2,0.2,"[0, 20, 40]",0.0003,0.002,0.001,3
4442,0.011319999999999327,0.5428571428571428,2,11,22,35,31,4,10,16,15,2,0.2,"[0, 20, 40]",0.0003,0.002,0.001,5
4443,0.0029399999999997076,0.5,1,1,6,8,8,0,10,16,15,2,0.2,"[0, 20, 40]",0.0003,0.002,0.0015,1
4444,0.003909999999998875,0.375,2,4,18,24,21,3,10,16,15,2,0.2,"[0, 20, 40]",0.0003,0.002,0.0015,3
4445,0.009719999999999056,0.45714285714285713,3,6,26,35,31,4,10,16,15,2,0.2,"[0, 20, 40]",0.0003,0.002,0.0015,5
4446,0.0005499999999998725,0.3333333333333333,1,0,2,3,3,0,10,16,15,2,0.2,"[0, 20, 40]",0.0005,0.001,0.001,1
4447,0.0050599999999996394,0.6428571428571429,3,4,7,14,13,1,10,16,15,2,0.2,"[0, 20, 40]",0.0005,0.001,0.001,3
4448,0.007899999999999258,0.5833333333333334,6,6,12,24,23,1,10,16,15,2,0.2,"[0, 20, 40]",0.0005,0.001,0.001,5
4449,0.0005499999999998725,0.3333333333333333,1,0,2,3,3,0,10,16,15,2,0.2,"[0, 20, 40]",0.0005,0.001,0.0015,1
4450,0.005249999999999385,0.5714285714285714,3,3,8,14,13,1,10,16,15,2,0.2,"[0, 20, 40]",0.0005,0.001,0.0015,3
4451,0.009089999999999002,0.5416666666666666,6,5,13,24,23,1,10,16,15,2,0.2,"[0, 20, 40]",0.0005,0.001,0.0015,5
4452,0.0004999999999996569,0.3333333333333333,0,0,3,3,3,0,10,16,15,2,0.2,"[0, 20, 40]",0.0005,0.0015,0.001,1
4453,0.0057599999999993975,0.6428571428571429,1,4,9,14,13,1,10,16,15,2,0.2,"[0, 20, 40]",0.0005,0.0015,0.001,3
4454,0.00975999999999884,0.5833333333333334,3,6,15,24,23,1,10,16,15,2,0.2,"[0, 20, 40]",0.0005,0.0015,0.001,5
4455,0.0004999999999996569,0.3333333333333333,0,0,3,3,3,0,10,16,15,2,0.2,"[0, 20, 40]",0.0005,0.0015,0.0015,1
4456,0.005949999999999142,0.5714285714285714,1,3,10,14,13,1,10,16,15,2,0.2,"[0, 20, 40]",0.0005,0.0015,0.0015,3
4457,0.010949999999998586,0.5416666666666666,3,5,16,24,23,1,10,16,15,2,0.2,"[0, 20, 40]",0.0005,0.0015,0.0015,5
4458,0.0004999999999996569,0.3333333333333333,0,0,3,3,3,0,10,16,15,2,0.2,"[0, 20, 40]",0.0005,0.002,0.001,1
4459,0.006259999999999398,0.6428571428571429,1,4,9,14,13,1,10,16,15,2,0.2,"[0, 20, 40]",0.0005,0.002,0.001,3
4460,0.0104399999999988,0.5833333333333334,2,6,16,24,23,1,10,16,15,2,0.2,"[0, 20, 40]",0.0005,0.002,0.001,5
4461,0.0004999999999996569,0.3333333333333333,0,0,3,3,3,0,10,16,15,2,0.2,"[0, 20, 40]",0.0005,0.002,0.0015,1
4462,0.006449999999999142,0.5714285714285714,1,3,10,14,13,1,10,16,15,2,0.2,"[0, 20, 40]",0.0005,0.002,0.0015,3
4463,0.011629999999998544,0.5416666666666666,2,5,17,24,23,1,10,16,15,2,0.2,"[0, 20, 40]",0.0005,0.002,0.0015,5
4464,0.01082000000000002,0.7096774193548387,11,11,9,31,17,14,10,16,20,1,0.1,"[0, 20, 40]",0.0003,0.001,0.001,1
4465,0.024649999999999894,0.696969696969697,22,22,22,66,40,26,10,16,20,1,0.1,"[0, 20, 40]",0.0003,0.001,0.001,3
4466,0.033609999999999425,0.7058823529411765,30,27,28,85,57,28,10,16,20,1,0.1,"[0, 20, 40]",0.0003,0.001,0.001,5
4467,0.010130000000000215,0.6129032258064516,12,7,12,31,17,14,10,16,20,1,0.1,"[0, 20, 40]",0.0003,0.001,0.0015,1
4468,0.017300000000000103,0.5606060606060606,22,13,31,66,40,26,10,16,20,1,0.1,"[0, 20, 40]",0.0003,0.001,0.0015,3
4469,0.028879999999999694,0.611764705882353,31,17,37,85,56,29,10,16,20,1,0.1,"[0, 20, 40]",0.0003,0.001,0.0015,5
4470,0.013439999999999862,0.7096774193548387,6,13,12,31,17,14,10,16,20,1,0.1,"[0, 20, 40]",0.0003,0.0015,0.001,1
4471,0.026409999999999212,0.6515151515151515,10,25,31,66,40,26,10,16,20,1,0.1,"[0, 20, 40]",0.0003,0.0015,0.001,3
4472,0.035409999999998415,0.6588235294117647,13,30,42,85,57,28,10,16,20,1,0.1,"[0, 20, 40]",0.0003,0.0015,0.001,5
4473,0.014250000000000058,0.6129032258064516,9,7,15,31,17,14,10,16,20,1,0.1,"[0, 20, 40]",0.0003,0.0015,0.0015,1
4474,0.020559999999999416,0.5151515151515151,12,14,40,66,40,26,10,16,20,1,0.1,"[0, 20, 40]",0.0003,0.0015,0.0015,3
4475,0.03267999999999869,0.5647058823529412,16,18,51,85,56,29,10,16,20,1,0.1,"[0, 20, 40]",0.0003,0.0015,0.0015,5
4476,0.013729999999999657,0.7096774193548387,3,13,15,31,17,14,10,16,20,1,0.1,"[0, 20, 40]",0.0003,0.002,0.001,1
4477,0.028749999999999113,0.6515151515151515,7,25,34,66,40,26,10,16,20,1,0.1,"[0, 20, 40]",0.0003,0.002,0.001,3
4478,0.03567999999999816,0.6547619047619048,7,29,48,84,57,27,10,16,20,1,0.1,"[0, 20, 40]",0.0003,0.002,0.001,5
4479,0.015250000000000007,0.6129032258064516,5,7,19,31,17,14,10,16,20,1,0.1,"[0, 20, 40]",0.0003,0.002,0.0015,1
4480,0.023899999999999318,0.5151515151515151,9,14,43,66,40,26,10,16,20,1,0.1,"[0, 20, 40]",0.0003,0.002,0.0015,3
4481,0.03394999999999844,0.5595238095238095,10,17,57,84,56,28,10,16,20,1,0.1,"[0, 20, 40]",0.0003,0.002,0.0015,5
4482,0.005489999999999924,0.875,5,2,1,8,4,4,10,16,20,1,0.1,"[0, 20, 40]",0.0005,0.001,0.001,1
4483,0.018449999999999796,0.8125,12,12,8,32,21,11,10,16,20,1,0.1,"[0, 20, 40]",0.0005,0.001,0.001,3
4484,0.02532999999999938,0.76,18,16,16,50,38,12,10,16,20,1,0.1,"[0, 20, 40]",0.0005,0.001,0.001,5
4485,0.0038499999999997273,0.75,6,0,2,8,4,4,10,16,20,1,0.1,"[0, 20, 40]",0.0005,0.001,0.0015,1
4486,0.018159999999999555,0.71875,13,8,11,32,21,11,10,16,20,1,0.1,"[0, 20, 40]",0.0005,0.001,0.0015,3
4487,0.024779999999999053,0.68,19,11,20,50,38,12,10,16,20,1,0.1,"[0, 20, 40]",0.0005,0.001,0.0015,5
4488,0.004430000000000031,0.625,1,3,4,8,4,4,10,16,20,1,0.1,"[0, 20, 40]",0.0005,0.0015,0.001,1
4489,0.01916999999999985,0.75,6,13,13,32,21,11,10,16,20,1,0.1,"[0, 20, 40]",0.0005,0.0015,0.001,3
4490,0.028239999999999352,0.72,10,17,23,50,38,12,10,16,20,1,0.1,"[0, 20, 40]",0.0005,0.0015,0.001,5
4491,0.0014699999999997922,0.375,2,0,6,8,4,4,10,16,20,1,0.1,"[0, 20, 40]",0.0005,0.0015,0.0015,1
4492,0.017559999999999566,0.625,7,8,17,32,21,11,10,16,20,1,0.1,"[0, 20, 40]",0.0005,0.0015,0.0015,3
4493,0.02636999999999898,0.62,11,11,28,50,38,12,10,16,20,1,0.1,"[0, 20, 40]",0.0005,0.0015,0.0015,5
4494,0.004930000000000032,0.625,1,3,4,8,4,4,10,16,20,1,0.1,"[0, 20, 40]",0.0005,0.002,0.001,1
4495,0.021449999999999796,0.75,5,13,14,32,21,11,10,16,20,1,0.1,"[0, 20, 40]",0.0005,0.002,0.001,3
4496,0.030079999999998865,0.72,7,17,26,50,38,12,10,16,20,1,0.1,"[0, 20, 40]",0.0005,0.002,0.001,5
4497,0.0024699999999997922,0.375,2,0,6,8,4,4,10,16,20,1,0.1,"[0, 20, 40]",0.0005,0.002,0.0015,1
4498,0.020339999999999515,0.625,6,8,18,32,21,11,10,16,20,1,0.1,"[0, 20, 40]",0.0005,0.002,0.0015,3
4499,0.028709999999998494,0.62,8,11,31,50,38,12,10,16,20,1,0.1,"[0, 20, 40]",0.0005,0.002,0.0015,5
4500,0.002930000000000004,0.7142857142857143,7,3,4,14,11,3,10,16,20,1,0.2,"[0, 20, 40]",0.0003,0.001,0.001,1
4501,0.007650000000000153,0.6666666666666666,10,8,12,30,23,7,10,16,20,1,0.2,"[0, 20, 40]",0.0003,0.001,0.001,3
4502,0.01384000000000006,0.7,15,11,14,40,32,8,10,16,20,1,0.2,"[0, 20, 40]",0.0003,0.001,0.001,5
4503,0.004430000000000003,0.7142857142857143,7,3,4,14,11,3,10,16,20,1,0.2,"[0, 20, 40]",0.0003,0.001,0.0015,1
4504,0.007420000000000084,0.6,10,6,14,30,23,7,10,16,20,1,0.2,"[0, 20, 40]",0.0003,0.001,0.0015,3
4505,0.015109999999999993,0.65,15,9,16,40,32,8,10,16,20,1,0.2,"[0, 20, 40]",0.0003,0.001,0.0015,5
4506,0.005059999999999912,0.7142857142857143,5,4,5,14,11,3,10,16,20,1,0.2,"[0, 20, 40]",0.0003,0.0015,0.001,1
4507,0.009989999999999768,0.6666666666666666,5,9,16,30,23,7,10,16,20,1,0.2,"[0, 20, 40]",0.0003,0.0015,0.001,3
4508,0.016739999999999568,0.7,7,12,21,40,32,8,10,16,20,1,0.2,"[0, 20, 40]",0.0003,0.0015,0.001,5
4509,0.007059999999999912,0.7142857142857143,6,3,5,14,11,3,10,16,20,1,0.2,"[0, 20, 40]",0.0003,0.0015,0.0015,1
4510,0.010259999999999703,0.6,6,6,18,30,23,7,10,16,20,1,0.2,"[0, 20, 40]",0.0003,0.0015,0.0015,3
4511,0.018509999999999503,0.65,8,9,23,40,32,8,10,16,20,1,0.2,"[0, 20, 40]",0.0003,0.0015,0.0015,5
4512,0.004849999999999706,0.7142857142857143,2,4,8,14,11,3,10,16,20,1,0.2,"[0, 20, 40]",0.0003,0.002,0.001,1
4513,0.010819999999999712,0.6666666666666666,3,9,18,30,23,7,10,16,20,1,0.2,"[0, 20, 40]",0.0003,0.002,0.001,3
4514,0.01577999999999936,0.6923076923076923,3,11,25,39,32,7,10,16,20,1,0.2,"[0, 20, 40]",0.0003,0.002,0.001,5
4515,0.007349999999999704,0.7142857142857143,3,3,8,14,11,3,10,16,20,1,0.2,"[0, 20, 40]",0.0003,0.002,0.0015,1
4516,0.011589999999999647,0.6,4,6,20,30,23,7,10,16,20,1,0.2,"[0, 20, 40]",0.0003,0.002,0.0015,3
4517,0.01754999999999929,0.6410256410256411,4,8,27,39,32,7,10,16,20,1,0.2,"[0, 20, 40]",0.0003,0.002,0.0015,5
4518,0.0022899999999999236,0.75,3,0,1,4,3,1,10,16,20,1,0.2,"[0, 20, 40]",0.0005,0.001,0.001,1
4519,0.010739999999999878,0.7894736842105263,6,7,6,19,16,3,10,16,20,1,0.2,"[0, 20, 40]",0.0005,0.001,0.001,3
4520,0.014979999999999672,0.7586206896551724,9,10,10,29,26,3,10,16,20,1,0.2,"[0, 20, 40]",0.0005,0.001,0.001,5
4521,0.0022899999999999236,0.75,3,0,1,4,3,1,10,16,20,1,0.2,"[0, 20, 40]",0.0005,0.001,0.0015,1
4522,0.012729999999999806,0.7368421052631579,6,6,7,19,16,3,10,16,20,1,0.2,"[0, 20, 40]",0.0005,0.001,0.0015,3
4523,0.01620999999999951,0.6896551724137931,9,8,12,29,26,3,10,16,20,1,0.2,"[0, 20, 40]",0.0005,0.001,0.0015,5
4524,0.00261999999999981,0.75,1,1,2,4,3,1,10,16,20,1,0.2,"[0, 20, 40]",0.0005,0.0015,0.001,1
4525,0.012569999999999758,0.7894736842105263,4,8,7,19,16,3,10,16,20,1,0.2,"[0, 20, 40]",0.0005,0.0015,0.001,3
4526,0.01749999999999947,0.7586206896551724,5,11,13,29,26,3,10,16,20,1,0.2,"[0, 20, 40]",0.0005,0.0015,0.001,5
4527,0.0007999999999997668,0.5,1,0,3,4,3,1,10,16,20,1,0.2,"[0, 20, 40]",0.0005,0.0015,0.0015,1
4528,0.012739999999999651,0.6842105263157895,4,6,9,19,16,3,10,16,20,1,0.2,"[0, 20, 40]",0.0005,0.0015,0.0015,3
4529,0.016909999999999266,0.6551724137931034,5,8,16,29,26,3,10,16,20,1,0.2,"[0, 20, 40]",0.0005,0.0015,0.0015,5
4530,0.00311999999999981,0.75,1,1,2,4,3,1,10,16,20,1,0.2,"[0, 20, 40]",0.0005,0.002,0.001,1
4531,0.013849999999999708,0.7894736842105263,3,8,8,19,16,3,10,16,20,1,0.2,"[0, 20, 40]",0.0005,0.002,0.001,3
4532,0.0180599999999992,0.7586206896551724,3,11,15,29,26,3,10,16,20,1,0.2,"[0, 20, 40]",0.0005,0.002,0.001,5
4533,0.0012999999999997668,0.5,1,0,3,4,3,1,10,16,20,1,0.2,"[0, 20, 40]",0.0005,0.002,0.0015,1
4534,0.014019999999999597,0.6842105263157895,3,6,10,19,16,3,10,16,20,1,0.2,"[0, 20, 40]",0.0005,0.002,0.0015,3
4535,0.017469999999998997,0.6551724137931034,3,8,18,29,26,3,10,16,20,1,0.2,"[0, 20, 40]",0.0005,0.002,0.0015,5
4536,0.006859999999999838,0.5714285714285714,6,6,9,21,14,7,10,16,20,2,0.1,"[0, 20, 40]",0.0003,0.001,0.001,1
4537,0.019499999999999632,0.6111111111111112,15,16,23,54,38,16,10,16,20,2,0.1,"[0, 20, 40]",0.0003,0.001,0.001,3
4538,0.02855999999999942,0.647887323943662,23,21,27,71,54,17,10,16,20,2,0.1,"[0, 20, 40]",0.0003,0.001,0.001,5
4539,0.008519999999999998,0.5238095238095238,6,5,10,21,14,7,10,16,20,2,0.1,"[0, 20, 40]",0.0003,0.001,0.0015,1
4540,0.019039999999999724,0.5370370370370371,15,12,27,54,38,16,10,16,20,2,0.1,"[0, 20, 40]",0.0003,0.001,0.0015,3
4541,0.03031999999999965,0.6,24,16,30,70,53,17,10,16,20,2,0.1,"[0, 20, 40]",0.0003,0.001,0.0015,5
4542,0.007479999999999682,0.5714285714285714,2,7,12,21,14,7,10,16,20,2,0.1,"[0, 20, 40]",0.0003,0.0015,0.001,1
4543,0.019189999999998993,0.5740740740740741,5,18,31,54,38,16,10,16,20,2,0.1,"[0, 20, 40]",0.0003,0.0015,0.001,3
4544,0.027469999999998638,0.6,8,23,39,70,54,16,10,16,20,2,0.1,"[0, 20, 40]",0.0003,0.0015,0.001,5
4545,0.00963999999999984,0.5238095238095238,3,5,13,21,14,7,10,16,20,2,0.1,"[0, 20, 40]",0.0003,0.0015,0.0015,1
4546,0.019729999999999085,0.5,6,13,35,54,38,16,10,16,20,2,0.1,"[0, 20, 40]",0.0003,0.0015,0.0015,3
4547,0.030729999999998862,0.5507246376811594,10,17,42,69,53,16,10,16,20,2,0.1,"[0, 20, 40]",0.0003,0.0015,0.0015,5
4548,0.008479999999999682,0.5714285714285714,2,7,12,21,14,7,10,16,20,2,0.1,"[0, 20, 40]",0.0003,0.002,0.001,1
4549,0.02069999999999895,0.5740740740740741,4,18,32,54,38,16,10,16,20,2,0.1,"[0, 20, 40]",0.0003,0.002,0.001,3
4550,0.02770999999999844,0.6,4,23,43,70,54,16,10,16,20,2,0.1,"[0, 20, 40]",0.0003,0.002,0.001,5
4551,0.011139999999999841,0.5238095238095238,3,5,13,21,14,7,10,16,20,2,0.1,"[0, 20, 40]",0.0003,0.002,0.0015,1
4552,0.02173999999999904,0.5,5,13,36,54,38,16,10,16,20,2,0.1,"[0, 20, 40]",0.0003,0.002,0.0015,3
4553,0.03196999999999867,0.5507246376811594,6,17,46,69,53,16,10,16,20,2,0.1,"[0, 20, 40]",0.0003,0.002,0.0015,5
4554,0.005610000000000022,0.7777777777777778,5,2,2,9,6,3,10,16,20,2,0.1,"[0, 20, 40]",0.0005,0.001,0.001,1
4555,0.017259999999999973,0.8214285714285714,11,10,7,28,22,6,10,16,20,2,0.1,"[0, 20, 40]",0.0005,0.001,0.001,3
4556,0.024209999999999735,0.7727272727272727,17,13,14,44,38,6,10,16,20,2,0.1,"[0, 20, 40]",0.0005,0.001,0.001,5
4557,0.004469999999999826,0.6666666666666666,5,1,3,9,6,3,10,16,20,2,0.1,"[0, 20, 40]",0.0005,0.001,0.0015,1
4558,0.01860999999999971,0.75,11,8,9,28,22,6,10,16,20,2,0.1,"[0, 20, 40]",0.0005,0.001,0.0015,3
4559,0.02479999999999938,0.7045454545454546,17,10,17,44,38,6,10,16,20,2,0.1,"[0, 20, 40]",0.0005,0.001,0.0015,5
4560,0.004550000000000129,0.5555555555555556,1,3,5,9,6,3,10,16,20,2,0.1,"[0, 20, 40]",0.0005,0.0015,0.001,1
4561,0.01716999999999983,0.75,4,11,13,28,22,6,10,16,20,2,0.1,"[0, 20, 40]",0.0005,0.0015,0.001,3
4562,0.026309999999999504,0.7272727272727273,8,14,22,44,38,6,10,16,20,2,0.1,"[0, 20, 40]",0.0005,0.0015,0.001,5
4563,0.0015899999999998901,0.3333333333333333,1,1,7,9,6,3,10,16,20,2,0.1,"[0, 20, 40]",0.0005,0.0015,0.0015,1
4564,0.01669999999999952,0.6428571428571429,4,8,16,28,22,6,10,16,20,2,0.1,"[0, 20, 40]",0.0005,0.0015,0.0015,3
4565,0.025079999999999113,0.6363636363636364,8,10,26,44,38,6,10,16,20,2,0.1,"[0, 20, 40]",0.0005,0.0015,0.0015,5
4566,0.005050000000000129,0.5555555555555556,1,3,5,9,6,3,10,16,20,2,0.1,"[0, 20, 40]",0.0005,0.002,0.001,1
4567,0.01844999999999978,0.75,3,11,14,28,22,6,10,16,20,2,0.1,"[0, 20, 40]",0.0005,0.002,0.001,3
4568,0.027149999999999015,0.7272727272727273,5,14,25,44,38,6,10,16,20,2,0.1,"[0, 20, 40]",0.0005,0.002,0.001,5
4569,0.00208999999999989,0.3333333333333333,1,1,7,9,6,3,10,16,20,2,0.1,"[0, 20, 40]",0.0005,0.002,0.0015,1
4570,0.01797999999999947,0.6428571428571429,3,8,17,28,22,6,10,16,20,2,0.1,"[0, 20, 40]",0.0005,0.002,0.0015,3
4571,0.02591999999999862,0.6363636363636364,5,10,29,44,38,6,10,16,20,2,0.1,"[0, 20, 40]",0.0005,0.002,0.0015,5
4572,0.0030499999999997057,0.625,3,2,3,8,8,0,10,16,20,2,0.2,"[0, 20, 40]",0.0003,0.001,0.001,1
4573,0.008270000000000062,0.6363636363636364,4,9,9,22,19,3,10,16,20,2,0.2,"[0, 20, 40]",0.0003,0.001,0.001,3
4574,0.015259999999999973,0.696969696969697,9,13,11,33,29,4,10,16,20,2,0.2,"[0, 20, 40]",0.0003,0.001,0.001,5
4575,0.004049999999999705,0.625,3,2,3,8,8,0,10,16,20,2,0.2,"[0, 20, 40]",0.0003,0.001,0.0015,1
4576,0.005649999999999992,0.5,4,6,12,22,19,3,10,16,20,2,0.2,"[0, 20, 40]",0.0003,0.001,0.0015,3
4577,0.014139999999999904,0.6060606060606061,10,9,14,33,29,4,10,16,20,2,0.2,"[0, 20, 40]",0.0003,0.001,0.0015,5
4578,0.0031799999999996137,0.625,1,3,4,8,8,0,10,16,20,2,0.2,"[0, 20, 40]",0.0003,0.0015,0.001,1
4579,0.007739999999999921,0.6363636363636364,0,11,11,22,19,3,10,16,20,2,0.2,"[0, 20, 40]",0.0003,0.0015,0.001,3
4580,0.01411999999999967,0.6666666666666666,1,15,17,33,29,4,10,16,20,2,0.2,"[0, 20, 40]",0.0003,0.0015,0.001,5
4581,0.004679999999999613,0.625,2,2,4,8,8,0,10,16,20,2,0.2,"[0, 20, 40]",0.0003,0.0015,0.0015,1
4582,0.006119999999999851,0.5,1,7,14,22,19,3,10,16,20,2,0.2,"[0, 20, 40]",0.0003,0.0015,0.0015,3
4583,0.0144999999999996,0.5757575757575758,3,10,20,33,29,4,10,16,20,2,0.2,"[0, 20, 40]",0.0003,0.0015,0.0015,5
4584,0.0036799999999996137,0.625,1,3,4,8,8,0,10,16,20,2,0.2,"[0, 20, 40]",0.0003,0.002,0.001,1
4585,0.007739999999999921,0.6363636363636364,0,11,11,22,19,3,10,16,20,2,0.2,"[0, 20, 40]",0.0003,0.002,0.001,3
4586,0.013569999999999676,0.6666666666666666,0,15,18,33,29,4,10,16,20,2,0.2,"[0, 20, 40]",0.0003,0.002,0.001,5
4587,0.005679999999999614,0.625,2,2,4,8,8,0,10,16,20,2,0.2,"[0, 20, 40]",0.0003,0.002,0.0015,1
4588,0.006619999999999852,0.5,1,7,14,22,19,3,10,16,20,2,0.2,"[0, 20, 40]",0.0003,0.002,0.0015,3
4589,0.014949999999999606,0.5757575757575758,2,10,21,33,29,4,10,16,20,2,0.2,"[0, 20, 40]",0.0003,0.002,0.0015,5
4590,0.0014899999999999237,0.6666666666666666,1,1,1,3,3,0,10,16,20,2,0.2,"[0, 20, 40]",0.0005,0.001,0.001,1
4591,0.00676000000000003,0.7692307692307693,2,6,5,13,12,1,10,16,20,2,0.2,"[0, 20, 40]",0.0005,0.001,0.001,3
4592,0.012659999999999932,0.782608695652174,6,9,8,23,22,1,10,16,20,2,0.2,"[0, 20, 40]",0.0005,0.001,0.001,5
4593,0.0019899999999999233,0.6666666666666666,1,1,1,3,3,0,10,16,20,2,0.2,"[0, 20, 40]",0.0005,0.001,0.0015,1
4594,0.008249999999999962,0.6923076923076923,2,5,6,13,12,1,10,16,20,2,0.2,"[0, 20, 40]",0.0005,0.001,0.0015,3
4595,0.013389999999999768,0.6956521739130435,6,7,10,23,22,1,10,16,20,2,0.2,"[0, 20, 40]",0.0005,0.001,0.0015,5
4596,0.00131999999999981,0.6666666666666666,0,1,2,3,3,0,10,16,20,2,0.2,"[0, 20, 40]",0.0005,0.0015,0.001,1
4597,0.007089999999999916,0.7692307692307693,1,6,6,13,12,1,10,16,20,2,0.2,"[0, 20, 40]",0.0005,0.0015,0.001,3
4598,0.014179999999999731,0.782608695652174,3,9,11,23,22,1,10,16,20,2,0.2,"[0, 20, 40]",0.0005,0.0015,0.001,5
4599,0.0018199999999998098,0.6666666666666666,0,1,2,3,3,0,10,16,20,2,0.2,"[0, 20, 40]",0.0005,0.0015,0.0015,1
4600,0.008579999999999848,0.6923076923076923,1,5,7,13,12,1,10,16,20,2,0.2,"[0, 20, 40]",0.0005,0.0015,0.0015,3
4601,0.014909999999999566,0.6956521739130435,3,7,13,23,22,1,10,16,20,2,0.2,"[0, 20, 40]",0.0005,0.0015,0.0015,5
4602,0.00131999999999981,0.6666666666666666,0,1,2,3,3,0,10,16,20,2,0.2,"[0, 20, 40]",0.0005,0.002,0.001,1
4603,0.007589999999999916,0.7692307692307693,1,6,6,13,12,1,10,16,20,2,0.2,"[0, 20, 40]",0.0005,0.002,0.001,3
4604,0.014459999999999511,0.782608695652174,2,9,12,23,22,1,10,16,20,2,0.2,"[0, 20, 40]",0.0005,0.002,0.001,5
4605,0.0018199999999998098,0.6666666666666666,0,1,2,3,3,0,10,16,20,2,0.2,"[0, 20, 40]",0.0005,0.002,0.0015,1
4606,0.009079999999999849,0.6923076923076923,1,5,7,13,12,1,10,16,20,2,0.2,"[0, 20, 40]",0.0005,0.002,0.0015,3
4607,0.015189999999999346,0.6956521739130435,2,7,14,23,22,1,10,16,20,2,0.2,"[0, 20, 40]",0.0005,0.002,0.0015,5
4608,0.006509999999998752,0.40540540540540543,5,7,25,37,22,15,10,17,5,1,0.1,"[0, 20, 40]",0.0003,0.001,0.001,1
4609,-0.0009700000000029141,0.2875,6,9,65,80,50,30,10,17,5,1,0.1,"[0, 20, 40]",0.0003,0.001,0.001,3
4610,-0.004850000000004028,0.24752475247524752,6,10,85,101,69,32,10,17,5,1,0.1,"[0, 20, 40]",0.0003,0.001,0.001,5
4611,0.004089999999998773,0.32432432432432434,5,4,28,37,22,15,10,17,5,1,0.1,"[0, 20, 40]",0.0003,0.001,0.0015,1
4612,-0.007380000000003046,0.225,6,4,70,80,50,30,10,17,5,1,0.1,"[0, 20, 40]",0.0003,0.001,0.0015,3
4613,-0.011260000000004178,0.19801980198019803,7,4,90,101,69,32,10,17,5,1,0.1,"[0, 20, 40]",0.0003,0.001,0.0015,5
4614,0.005219999999998518,0.3783783783783784,0,8,29,37,22,15,10,17,5,1,0.1,"[0, 20, 40]",0.0003,0.0015,0.001,1
4615,-0.002190000000003242,0.275,0,10,70,80,50,30,10,17,5,1,0.1,"[0, 20, 40]",0.0003,0.0015,0.001,3
4616,-0.006070000000004355,0.2376237623762376,0,11,90,101,69,32,10,17,5,1,0.1,"[0, 20, 40]",0.0003,0.0015,0.001,5
4617,0.0012799999999986858,0.2702702702702703,0,4,33,37,22,15,10,17,5,1,0.1,"[0, 20, 40]",0.0003,0.0015,0.0015,1
4618,-0.010120000000003232,0.2,0,4,76,80,50,30,10,17,5,1,0.1,"[0, 20, 40]",0.0003,0.0015,0.0015,3
4619,-0.013900000000004482,0.1782178217821782,0,4,97,101,69,32,10,17,5,1,0.1,"[0, 20, 40]",0.0003,0.0015,0.0015,5
4620,0.005219999999998518,0.3783783783783784,0,8,29,37,22,15,10,17,5,1,0.1,"[0, 20, 40]",0.0003,0.002,0.001,1
4621,-0.002190000000003242,0.275,0,10,70,80,50,30,10,17,5,1,0.1,"[0, 20, 40]",0.0003,0.002,0.001,3
4622,-0.006070000000004355,0.2376237623762376,0,11,90,101,69,32,10,17,5,1,0.1,"[0, 20, 40]",0.0003,0.002,0.001,5
4623,0.0012799999999986858,0.2702702702702703,0,4,33,37,22,15,10,17,5,1,0.1,"[0, 20, 40]",0.0003,0.002,0.0015,1
4624,-0.010120000000003232,0.2,0,4,76,80,50,30,10,17,5,1,0.1,"[0, 20, 40]",0.0003,0.002,0.0015,3
4625,-0.013900000000004482,0.1782178217821782,0,4,97,101,69,32,10,17,5,1,0.1,"[0, 20, 40]",0.0003,0.002,0.0015,5
4626,0.002369999999999427,0.6,1,2,7,10,6,4,10,17,5,1,0.1,"[0, 20, 40]",0.0005,0.001,0.001,1
4627,0.0054199999999981615,0.4864864864864865,5,6,26,37,24,13,10,17,5,1,0.1,"[0, 20, 40]",0.0005,0.001,0.001,3
4628,0.0023099999999969673,0.39655172413793105,6,6,46,58,44,14,10,17,5,1,0.1,"[0, 20, 40]",0.0005,0.001,0.001,5
4629,-0.0021700000000007824,0.4,1,0,9,10,6,4,10,17,5,1,0.1,"[0, 20, 40]",0.0005,0.001,0.0015,1
4630,-0.006990000000002311,0.32432432432432434,5,0,32,37,24,13,10,17,5,1,0.1,"[0, 20, 40]",0.0005,0.001,0.0015,3
4631,-0.0101000000000035,0.29310344827586204,6,0,52,58,44,14,10,17,5,1,0.1,"[0, 20, 40]",0.0005,0.001,0.0015,5
4632,0.0013999999999994017,0.5,0,2,8,10,6,4,10,17,5,1,0.1,"[0, 20, 40]",0.0005,0.0015,0.001,1
4633,0.0038299999999980147,0.43243243243243246,1,6,30,37,24,13,10,17,5,1,0.1,"[0, 20, 40]",0.0005,0.0015,0.001,3
4634,0.0010199999999966802,0.3620689655172414,1,6,51,58,44,14,10,17,5,1,0.1,"[0, 20, 40]",0.0005,0.0015,0.001,5
4635,-0.003140000000000808,0.3,0,0,10,10,6,4,10,17,5,1,0.1,"[0, 20, 40]",0.0005,0.0015,0.0015,1
4636,-0.008580000000002457,0.2702702702702703,1,0,36,37,24,13,10,17,5,1,0.1,"[0, 20, 40]",0.0005,0.0015,0.0015,3
4637,-0.011390000000003793,0.25862068965517243,1,0,57,58,44,14,10,17,5,1,0.1,"[0, 20, 40]",0.0005,0.0015,0.0015,5
4638,0.0013999999999994017,0.5,0,2,8,10,6,4,10,17,5,1,0.1,"[0, 20, 40]",0.0005,0.002,0.001,1
4639,0.004089999999997999,0.43243243243243246,0,6,31,37,24,13,10,17,5,1,0.1,"[0, 20, 40]",0.0005,0.002,0.001,3
4640,0.0012799999999966649,0.3620689655172414,0,6,52,58,44,14,10,17,5,1,0.1,"[0, 20, 40]",0.0005,0.002,0.001,5
4641,-0.003140000000000808,0.3,0,0,10,10,6,4,10,17,5,1,0.1,"[0, 20, 40]",0.0005,0.002,0.0015,1
4642,-0.008320000000002473,0.2702702702702703,0,0,37,37,24,13,10,17,5,1,0.1,"[0, 20, 40]",0.0005,0.002,0.0015,3
4643,-0.011130000000003809,0.25862068965517243,0,0,58,58,44,14,10,17,5,1,0.1,"[0, 20, 40]",0.0005,0.002,0.0015,5
4644,0.0037599999999994946,0.4117647058823529,3,2,12,17,14,3,10,17,5,1,0.2,"[0, 20, 40]",0.0003,0.001,0.001,1
4645,-0.0015300000000012743,0.3055555555555556,3,3,30,36,29,7,10,17,5,1,0.2,"[0, 20, 40]",0.0003,0.001,0.001,3
4646,-0.004620000000001309,0.2391304347826087,3,3,40,46,38,8,10,17,5,1,0.2,"[0, 20, 40]",0.0003,0.001,0.001,5
4647,0.004759999999999497,0.4117647058823529,3,2,12,17,14,3,10,17,5,1,0.2,"[0, 20, 40]",0.0003,0.001,0.0015,1
4648,-0.002310000000001277,0.2777777777777778,3,2,31,36,29,7,10,17,5,1,0.2,"[0, 20, 40]",0.0003,0.001,0.0015,3
4649,-0.00540000000000131,0.21739130434782608,3,2,41,46,38,8,10,17,5,1,0.2,"[0, 20, 40]",0.0003,0.001,0.0015,5
4650,0.002409999999999424,0.35294117647058826,0,2,15,17,14,3,10,17,5,1,0.2,"[0, 20, 40]",0.0003,0.0015,0.001,1
4651,-0.002880000000001345,0.2777777777777778,0,3,33,36,29,7,10,17,5,1,0.2,"[0, 20, 40]",0.0003,0.0015,0.001,3
4652,-0.00597000000000138,0.21739130434782608,0,3,43,46,38,8,10,17,5,1,0.2,"[0, 20, 40]",0.0003,0.0015,0.001,5
4653,0.003409999999999426,0.35294117647058826,0,2,15,17,14,3,10,17,5,1,0.2,"[0, 20, 40]",0.0003,0.0015,0.0015,1
4654,-0.003660000000001348,0.25,0,2,34,36,29,7,10,17,5,1,0.2,"[0, 20, 40]",0.0003,0.0015,0.0015,3
4655,-0.006750000000001381,0.1956521739130435,0,2,44,46,38,8,10,17,5,1,0.2,"[0, 20, 40]",0.0003,0.0015,0.0015,5
4656,0.002409999999999424,0.35294117647058826,0,2,15,17,14,3,10,17,5,1,0.2,"[0, 20, 40]",0.0003,0.002,0.001,1
4657,-0.002880000000001345,0.2777777777777778,0,3,33,36,29,7,10,17,5,1,0.2,"[0, 20, 40]",0.0003,0.002,0.001,3
4658,-0.00597000000000138,0.21739130434782608,0,3,43,46,38,8,10,17,5,1,0.2,"[0, 20, 40]",0.0003,0.002,0.001,5
4659,0.003409999999999426,0.35294117647058826,0,2,15,17,14,3,10,17,5,1,0.2,"[0, 20, 40]",0.0003,0.002,0.0015,1
4660,-0.003660000000001348,0.25,0,2,34,36,29,7,10,17,5,1,0.2,"[0, 20, 40]",0.0003,0.002,0.0015,3
4661,-0.006750000000001381,0.1956521739130435,0,2,44,46,38,8,10,17,5,1,0.2,"[0, 20, 40]",0.0003,0.002,0.0015,5
4662,0.0017999999999995797,0.8,0,1,4,5,4,1,10,17,5,1,0.2,"[0, 20, 40]",0.0005,0.001,0.001,1
4663,0.0012599999999988168,0.45,2,3,15,20,17,3,10,17,5,1,0.2,"[0, 20, 40]",0.0005,0.001,0.001,3
4664,-0.0012600000000017259,0.3225806451612903,2,3,26,31,28,3,10,17,5,1,0.2,"[0, 20, 40]",0.0005,0.001,0.001,5
4665,-0.0004800000000005905,0.6,0,0,5,5,4,1,10,17,5,1,0.2,"[0, 20, 40]",0.0005,0.001,0.0015,1
4666,-0.0050800000000015225,0.3,2,0,18,20,17,3,10,17,5,1,0.2,"[0, 20, 40]",0.0005,0.001,0.0015,3
4667,-0.007600000000002067,0.22580645161290322,2,0,29,31,28,3,10,17,5,1,0.2,"[0, 20, 40]",0.0005,0.001,0.0015,5
4668,0.0017999999999995797,0.8,0,1,4,5,4,1,10,17,5,1,0.2,"[0, 20, 40]",0.0005,0.0015,0.001,1
4669,0.0009799999999987037,0.4,1,3,16,20,17,3,10,17,5,1,0.2,"[0, 20, 40]",0.0005,0.0015,0.001,3
4670,-0.001540000000001839,0.2903225806451613,1,3,27,31,28,3,10,17,5,1,0.2,"[0, 20, 40]",0.0005,0.0015,0.001,5
4671,-0.0004800000000005905,0.6,0,0,5,5,4,1,10,17,5,1,0.2,"[0, 20, 40]",0.0005,0.0015,0.0015,1
4672,-0.005360000000001636,0.25,1,0,19,20,17,3,10,17,5,1,0.2,"[0, 20, 40]",0.0005,0.0015,0.0015,3
4673,-0.00788000000000218,0.1935483870967742,1,0,30,31,28,3,10,17,5,1,0.2,"[0, 20, 40]",0.0005,0.0015,0.0015,5
4674,0.0017999999999995797,0.8,0,1,4,5,4,1,10,17,5,1,0.2,"[0, 20, 40]",0.0005,0.002,0.001,1
4675,0.0012399999999986875,0.4,0,3,17,20,17,3,10,17,5,1,0.2,"[0, 20, 40]",0.0005,0.002,0.001,3
4676,-0.0012800000000018552,0.2903225806451613,0,3,28,31,28,3,10,17,5,1,0.2,"[0, 20, 40]",0.0005,0.002,0.001,5
4677,-0.0004800000000005905,0.6,0,0,5,5,4,1,10,17,5,1,0.2,"[0, 20, 40]",0.0005,0.002,0.0015,1
4678,-0.005100000000001653,0.25,0,0,20,20,17,3,10,17,5,1,0.2,"[0, 20, 40]",0.0005,0.002,0.0015,3
4679,-0.007620000000002193,0.1935483870967742,0,0,31,31,28,3,10,17,5,1,0.2,"[0, 20, 40]",0.0005,0.002,0.0015,5
4680,0.0032599999999991056,0.37037037037037035,3,4,20,27,19,8,10,17,5,2,0.1,"[0, 20, 40]",0.0003,0.001,0.001,1
4681,-0.00399000000000262,0.25757575757575757,4,7,55,66,49,17,10,17,5,2,0.1,"[0, 20, 40]",0.0003,0.001,0.001,3
4682,-0.006330000000003524,0.23170731707317074,4,8,70,82,64,18,10,17,5,2,0.1,"[0, 20, 40]",0.0003,0.001,0.001,5
4683,0.0036999999999991562,0.3333333333333333,3,3,21,27,19,8,10,17,5,2,0.1,"[0, 20, 40]",0.0003,0.001,0.0015,1
4684,-0.007040000000002728,0.21212121212121213,4,4,58,66,49,17,10,17,5,2,0.1,"[0, 20, 40]",0.0003,0.001,0.0015,3
4685,-0.009380000000003648,0.1951219512195122,5,4,73,82,64,18,10,17,5,2,0.1,"[0, 20, 40]",0.0003,0.001,0.0015,5
4686,0.0014699999999990393,0.3333333333333333,0,4,23,27,19,8,10,17,5,2,0.1,"[0, 20, 40]",0.0003,0.0015,0.001,1
4687,-0.005710000000002781,0.24242424242424243,0,7,59,66,49,17,10,17,5,2,0.1,"[0, 20, 40]",0.0003,0.0015,0.001,3
4688,-0.00805000000000369,0.21951219512195122,0,8,74,82,64,18,10,17,5,2,0.1,"[0, 20, 40]",0.0003,0.0015,0.001,5
4689,0.0019099999999990895,0.2962962962962963,0,3,24,27,19,8,10,17,5,2,0.1,"[0, 20, 40]",0.0003,0.0015,0.0015,1
4690,-0.008760000000002897,0.19696969696969696,0,4,62,66,49,17,10,17,5,2,0.1,"[0, 20, 40]",0.0003,0.0015,0.0015,3
4691,-0.011000000000003932,0.18292682926829268,0,4,78,82,64,18,10,17,5,2,0.1,"[0, 20, 40]",0.0003,0.0015,0.0015,5
4692,0.0014699999999990393,0.3333333333333333,0,4,23,27,19,8,10,17,5,2,0.1,"[0, 20, 40]",0.0003,0.002,0.001,1
4693,-0.005710000000002781,0.24242424242424243,0,7,59,66,49,17,10,17,5,2,0.1,"[0, 20, 40]",0.0003,0.002,0.001,3
4694,-0.00805000000000369,0.21951219512195122,0,8,74,82,64,18,10,17,5,2,0.1,"[0, 20, 40]",0.0003,0.002,0.001,5
4695,0.0019099999999990895,0.2962962962962963,0,3,24,27,19,8,10,17,5,2,0.1,"[0, 20, 40]",0.0003,0.002,0.0015,1
4696,-0.008760000000002897,0.19696969696969696,0,4,62,66,49,17,10,17,5,2,0.1,"[0, 20, 40]",0.0003,0.002,0.0015,3
4697,-0.011000000000003932,0.18292682926829268,0,4,78,82,64,18,10,17,5,2,0.1,"[0, 20, 40]",0.0003,0.002,0.0015,5
4698,0.0024399999999996412,0.5454545454545454,1,2,8,11,8,3,10,17,5,2,0.1,"[0, 20, 40]",0.0005,0.001,0.001,1
4699,0.0037799999999986278,0.46875,3,6,23,32,26,6,10,17,5,2,0.1,"[0, 20, 40]",0.0005,0.001,0.001,3
4700,0.0020199999999981765,0.3958333333333333,4,6,38,48,42,6,10,17,5,2,0.1,"[0, 20, 40]",0.0005,0.001,0.001,5
4701,-0.002100000000000568,0.36363636363636365,1,0,10,11,8,3,10,17,5,2,0.1,"[0, 20, 40]",0.0005,0.001,0.0015,1
4702,-0.008740000000001899,0.28125,3,0,29,32,26,6,10,17,5,2,0.1,"[0, 20, 40]",0.0005,0.001,0.0015,3
4703,-0.010500000000002346,0.2708333333333333,4,0,44,48,42,6,10,17,5,2,0.1,"[0, 20, 40]",0.0005,0.001,0.0015,5
4704,0.001469999999999616,0.45454545454545453,0,2,9,11,8,3,10,17,5,2,0.1,"[0, 20, 40]",0.0005,0.0015,0.001,1
4705,0.0021699999999984067,0.40625,0,6,26,32,26,6,10,17,5,2,0.1,"[0, 20, 40]",0.0005,0.0015,0.001,3
4706,0.0007099999999978135,0.3541666666666667,0,6,42,48,42,6,10,17,5,2,0.1,"[0, 20, 40]",0.0005,0.0015,0.001,5
4707,-0.0030700000000005935,0.2727272727272727,0,0,11,11,8,3,10,17,5,2,0.1,"[0, 20, 40]",0.0005,0.0015,0.0015,1
4708,-0.010350000000002121,0.21875,0,0,32,32,26,6,10,17,5,2,0.1,"[0, 20, 40]",0.0005,0.0015,0.0015,3
4709,-0.011810000000002716,0.22916666666666666,0,0,48,48,42,6,10,17,5,2,0.1,"[0, 20, 40]",0.0005,0.0015,0.0015,5
4710,0.001469999999999616,0.45454545454545453,0,2,9,11,8,3,10,17,5,2,0.1,"[0, 20, 40]",0.0005,0.002,0.001,1
4711,0.0021699999999984067,0.40625,0,6,26,32,26,6,10,17,5,2,0.1,"[0, 20, 40]",0.0005,0.002,0.001,3
4712,0.0007099999999978135,0.3541666666666667,0,6,42,48,42,6,10,17,5,2,0.1,"[0, 20, 40]",0.0005,0.002,0.001,5
4713,-0.0030700000000005935,0.2727272727272727,0,0,11,11,8,3,10,17,5,2,0.1,"[0, 20, 40]",0.0005,0.002,0.0015,1
4714,-0.010350000000002121,0.21875,0,0,32,32,26,6,10,17,5,2,0.1,"[0, 20, 40]",0.0005,0.002,0.0015,3
4715,-0.011810000000002716,0.22916666666666666,0,0,48,48,42,6,10,17,5,2,0.1,"[0, 20, 40]",0.0005,0.002,0.0015,5
4716,0.0037399999999996963,0.5833333333333334,3,2,7,12,12,0,10,17,5,2,0.2,"[0, 20, 40]",0.0003,0.001,0.001,1
4717,0.0005999999999987337,0.3793103448275862,3,4,22,29,26,3,10,17,5,2,0.2,"[0, 20, 40]",0.0003,0.001,0.001,3
4718,-0.0009400000000014743,0.3076923076923077,3,5,31,39,35,4,10,17,5,2,0.2,"[0, 20, 40]",0.0003,0.001,0.001,5
4719,0.004739999999999697,0.5833333333333334,3,2,7,12,12,0,10,17,5,2,0.2,"[0, 20, 40]",0.0003,0.001,0.0015,1
4720,0.0003199999999987305,0.3448275862068966,3,3,23,29,26,3,10,17,5,2,0.2,"[0, 20, 40]",0.0003,0.001,0.0015,3
4721,-0.0012200000000014781,0.28205128205128205,4,3,32,39,35,4,10,17,5,2,0.2,"[0, 20, 40]",0.0003,0.001,0.0015,5
4722,0.0019499999999996295,0.5,0,2,10,12,12,0,10,17,5,2,0.2,"[0, 20, 40]",0.0003,0.0015,0.001,1
4723,-0.0011900000000013332,0.3448275862068966,0,4,25,29,26,3,10,17,5,2,0.2,"[0, 20, 40]",0.0003,0.0015,0.001,3
4724,-0.002730000000001541,0.28205128205128205,0,5,34,39,35,4,10,17,5,2,0.2,"[0, 20, 40]",0.0003,0.0015,0.001,5
4725,0.002949999999999629,0.5,0,2,10,12,12,0,10,17,5,2,0.2,"[0, 20, 40]",0.0003,0.0015,0.0015,1
4726,-0.0014700000000013361,0.3103448275862069,0,3,26,29,26,3,10,17,5,2,0.2,"[0, 20, 40]",0.0003,0.0015,0.0015,3
4727,-0.0029100000000016665,0.2564102564102564,0,3,36,39,35,4,10,17,5,2,0.2,"[0, 20, 40]",0.0003,0.0015,0.0015,5
4728,0.0019499999999996295,0.5,0,2,10,12,12,0,10,17,5,2,0.2,"[0, 20, 40]",0.0003,0.002,0.001,1
4729,-0.0011900000000013332,0.3448275862068966,0,4,25,29,26,3,10,17,5,2,0.2,"[0, 20, 40]",0.0003,0.002,0.001,3
4730,-0.002730000000001541,0.28205128205128205,0,5,34,39,35,4,10,17,5,2,0.2,"[0, 20, 40]",0.0003,0.002,0.001,5
4731,0.002949999999999629,0.5,0,2,10,12,12,0,10,17,5,2,0.2,"[0, 20, 40]",0.0003,0.002,0.0015,1
4732,-0.0014700000000013361,0.3103448275862069,0,3,26,29,26,3,10,17,5,2,0.2,"[0, 20, 40]",0.0003,0.002,0.0015,3
4733,-0.0029100000000016665,0.2564102564102564,0,3,36,39,35,4,10,17,5,2,0.2,"[0, 20, 40]",0.0003,0.002,0.0015,5
4734,0.0005699999999997595,0.5,0,1,3,4,4,0,10,17,5,2,0.2,"[0, 20, 40]",0.0005,0.001,0.001,1
4735,0.002229999999999152,0.5,2,4,10,16,15,1,10,17,5,2,0.2,"[0, 20, 40]",0.0005,0.001,0.001,3
4736,0.0017399999999989405,0.38461538461538464,3,4,19,26,25,1,10,17,5,2,0.2,"[0, 20, 40]",0.0005,0.001,0.001,5
4737,-0.0017100000000004108,0.25,0,0,4,4,4,0,10,17,5,2,0.2,"[0, 20, 40]",0.0005,0.001,0.0015,1
4738,-0.0060200000000011555,0.25,2,0,14,16,15,1,10,17,5,2,0.2,"[0, 20, 40]",0.0005,0.001,0.0015,3
4739,-0.0065100000000013645,0.23076923076923078,3,0,23,26,25,1,10,17,5,2,0.2,"[0, 20, 40]",0.0005,0.001,0.0015,5
4740,0.0005699999999997595,0.5,0,1,3,4,4,0,10,17,5,2,0.2,"[0, 20, 40]",0.0005,0.0015,0.001,1
4741,0.0015899999999989577,0.4375,0,4,12,16,15,1,10,17,5,2,0.2,"[0, 20, 40]",0.0005,0.0015,0.001,3
4742,0.0013999999999986029,0.34615384615384615,0,4,22,26,25,1,10,17,5,2,0.2,"[0, 20, 40]",0.0005,0.0015,0.001,5
4743,-0.0017100000000004108,0.25,0,0,4,4,4,0,10,17,5,2,0.2,"[0, 20, 40]",0.0005,0.0015,0.0015,1
4744,-0.00666000000000135,0.1875,0,0,16,16,15,1,10,17,5,2,0.2,"[0, 20, 40]",0.0005,0.0015,0.0015,3
4745,-0.006850000000001704,0.19230769230769232,0,0,26,26,25,1,10,17,5,2,0.2,"[0, 20, 40]",0.0005,0.0015,0.0015,5
4746,0.0005699999999997595,0.5,0,1,3,4,4,0,10,17,5,2,0.2,"[0, 20, 40]",0.0005,0.002,0.001,1
4747,0.0015899999999989577,0.4375,0,4,12,16,15,1,10,17,5,2,0.2,"[0, 20, 40]",0.0005,0.002,0.001,3
4748,0.0013999999999986029,0.34615384615384615,0,4,22,26,25,1,10,17,5,2,0.2,"[0, 20, 40]",0.0005,0.002,0.001,5
4749,-0.0017100000000004108,0.25,0,0,4,4,4,0,10,17,5,2,0.2,"[0, 20, 40]",0.0005,0.002,0.0015,1
4750,-0.00666000000000135,0.1875,0,0,16,16,15,1,10,17,5,2,0.2,"[0, 20, 40]",0.0005,0.002,0.0015,3
4751,-0.006850000000001704,0.19230769230769232,0,0,26,26,25,1,10,17,5,2,0.2,"[0, 20, 40]",0.0005,0.002,0.0015,5
4752,0.00932999999999868,0.5405405405405406,8,7,22,37,22,15,10,17,10,1,0.1,"[0, 20, 40]",0.0003,0.001,0.001,1
4753,0.006669999999998176,0.425,16,12,52,80,50,30,10,17,10,1,0.1,"[0, 20, 40]",0.0003,0.001,0.001,3
4754,0.011409999999997424,0.4411764705882353,18,16,68,102,70,32,10,17,10,1,0.1,"[0, 20, 40]",0.0003,0.001,0.001,5
4755,0.007389999999998737,0.4594594594594595,8,4,25,37,22,15,10,17,10,1,0.1,"[0, 20, 40]",0.0003,0.001,0.0015,1
4756,0.0028199999999980923,0.3625,16,7,57,80,50,30,10,17,10,1,0.1,"[0, 20, 40]",0.0003,0.001,0.0015,3
4757,0.004659999999997283,0.37254901960784315,19,8,75,102,70,32,10,17,10,1,0.1,"[0, 20, 40]",0.0003,0.001,0.0015,5
4758,0.010929999999998722,0.5405405405405406,4,9,24,37,22,15,10,17,10,1,0.1,"[0, 20, 40]",0.0003,0.0015,0.001,1
4759,0.007409999999997919,0.425,4,14,62,80,50,30,10,17,10,1,0.1,"[0, 20, 40]",0.0003,0.0015,0.001,3
4760,0.011969999999996877,0.4411764705882353,4,18,80,102,70,32,10,17,10,1,0.1,"[0, 20, 40]",0.0003,0.0015,0.001,5
4761,0.008809999999998652,0.43243243243243246,5,4,28,37,22,15,10,17,10,1,0.1,"[0, 20, 40]",0.0003,0.0015,0.0015,1
4762,0.0033799999999977186,0.35,5,7,68,80,50,30,10,17,10,1,0.1,"[0, 20, 40]",0.0003,0.0015,0.0015,3
4763,0.005299999999996435,0.3627450980392157,5,8,89,102,70,32,10,17,10,1,0.1,"[0, 20, 40]",0.0003,0.0015,0.0015,5
4764,0.01059999999999856,0.5405405405405406,2,9,26,37,22,15,10,17,10,1,0.1,"[0, 20, 40]",0.0003,0.002,0.001,1
4765,0.007079999999997757,0.425,2,14,64,80,50,30,10,17,10,1,0.1,"[0, 20, 40]",0.0003,0.002,0.001,3
4766,0.011639999999996719,0.4411764705882353,2,18,82,102,70,32,10,17,10,1,0.1,"[0, 20, 40]",0.0003,0.002,0.001,5
4767,0.008809999999998491,0.43243243243243246,2,4,31,37,22,15,10,17,10,1,0.1,"[0, 20, 40]",0.0003,0.002,0.0015,1
4768,0.0033799999999975555,0.35,2,7,71,80,50,30,10,17,10,1,0.1,"[0, 20, 40]",0.0003,0.002,0.0015,3
4769,0.005299999999996271,0.3627450980392157,2,8,92,102,70,32,10,17,10,1,0.1,"[0, 20, 40]",0.0003,0.002,0.0015,5
4770,0.006039999999999931,0.8,4,3,3,10,6,4,10,17,10,1,0.1,"[0, 20, 40]",0.0005,0.001,0.001,1
4771,0.011549999999999673,0.5945945945945946,11,8,18,37,24,13,10,17,10,1,0.1,"[0, 20, 40]",0.0005,0.001,0.001,3
4772,0.015959999999998434,0.559322033898305,16,10,33,59,45,14,10,17,10,1,0.1,"[0, 20, 40]",0.0005,0.001,0.001,5
4773,0.0033599999999999706,0.6,4,1,5,10,6,4,10,17,10,1,0.1,"[0, 20, 40]",0.0005,0.001,0.0015,1
4774,0.007159999999999561,0.4864864864864865,11,4,22,37,24,13,10,17,10,1,0.1,"[0, 20, 40]",0.0005,0.001,0.0015,3
4775,0.010629999999998094,0.4745762711864407,16,5,38,59,45,14,10,17,10,1,0.1,"[0, 20, 40]",0.0005,0.001,0.0015,5
4776,0.004449999999999452,0.6,1,3,6,10,6,4,10,17,10,1,0.1,"[0, 20, 40]",0.0005,0.0015,0.001,1
4777,0.012159999999999062,0.5405405405405406,5,8,24,37,24,13,10,17,10,1,0.1,"[0, 20, 40]",0.0005,0.0015,0.001,3
4778,0.017829999999997202,0.5254237288135594,7,10,42,59,45,14,10,17,10,1,0.1,"[0, 20, 40]",0.0005,0.0015,0.001,5
4779,0.0017699999999994933,0.4,1,1,8,10,6,4,10,17,10,1,0.1,"[0, 20, 40]",0.0005,0.0015,0.0015,1
4780,0.007769999999998951,0.43243243243243246,5,4,28,37,24,13,10,17,10,1,0.1,"[0, 20, 40]",0.0005,0.0015,0.0015,3
4781,0.012499999999996854,0.4406779661016949,7,5,47,59,45,14,10,17,10,1,0.1,"[0, 20, 40]",0.0005,0.0015,0.0015,5
4782,0.004949999999999451,0.6,1,3,6,10,6,4,10,17,10,1,0.1,"[0, 20, 40]",0.0005,0.002,0.001,1
4783,0.01165999999999873,0.5135135135135135,3,8,26,37,24,13,10,17,10,1,0.1,"[0, 20, 40]",0.0005,0.002,0.001,3
4784,0.0173699999999968,0.5084745762711864,4,10,45,59,45,14,10,17,10,1,0.1,"[0, 20, 40]",0.0005,0.002,0.001,5
4785,0.0022699999999994933,0.4,1,1,8,10,6,4,10,17,10,1,0.1,"[0, 20, 40]",0.0005,0.002,0.0015,1
4786,0.007269999999998619,0.40540540540540543,3,4,30,37,24,13,10,17,10,1,0.1,"[0, 20, 40]",0.0005,0.002,0.0015,3
4787,0.012039999999996453,0.423728813559322,4,5,50,59,45,14,10,17,10,1,0.1,"[0, 20, 40]",0.0005,0.002,0.0015,5
4788,0.0052999999999997025,0.5882352941176471,6,2,9,17,14,3,10,17,10,1,0.2,"[0, 20, 40]",0.0003,0.001,0.001,1
4789,0.0027799999999995315,0.4166666666666667,8,5,23,36,29,7,10,17,10,1,0.2,"[0, 20, 40]",0.0003,0.001,0.001,3
4790,0.007509999999999197,0.46808510638297873,9,8,30,47,39,8,10,17,10,1,0.2,"[0, 20, 40]",0.0003,0.001,0.001,5
4791,0.006299999999999704,0.5882352941176471,6,2,9,17,14,3,10,17,10,1,0.2,"[0, 20, 40]",0.0003,0.001,0.0015,1
4792,0.002619999999999482,0.3888888888888889,8,4,24,36,29,7,10,17,10,1,0.2,"[0, 20, 40]",0.0003,0.001,0.0015,3
4793,0.004449999999999069,0.40425531914893614,9,5,33,47,39,8,10,17,10,1,0.2,"[0, 20, 40]",0.0003,0.001,0.0015,5
4794,0.00639999999999975,0.5882352941176471,3,3,11,17,14,3,10,17,10,1,0.2,"[0, 20, 40]",0.0003,0.0015,0.001,1
4795,0.003359999999999503,0.4166666666666667,3,6,27,36,29,7,10,17,10,1,0.2,"[0, 20, 40]",0.0003,0.0015,0.001,3
4796,0.007869999999998947,0.46808510638297873,3,9,35,47,39,8,10,17,10,1,0.2,"[0, 20, 40]",0.0003,0.0015,0.001,5
4797,0.006719999999999626,0.5294117647058824,3,2,12,17,14,3,10,17,10,1,0.2,"[0, 20, 40]",0.0003,0.0015,0.0015,1
4798,0.0025199999999993296,0.3611111111111111,3,4,29,36,29,7,10,17,10,1,0.2,"[0, 20, 40]",0.0003,0.0015,0.0015,3
4799,0.004129999999998698,0.3829787234042553,3,5,39,47,39,8,10,17,10,1,0.2,"[0, 20, 40]",0.0003,0.0015,0.0015,5
4800,0.005569999999999585,0.5882352941176471,1,3,13,17,14,3,10,17,10,1,0.2,"[0, 20, 40]",0.0003,0.002,0.001,1
4801,0.0025299999999993427,0.4166666666666667,1,6,29,36,29,7,10,17,10,1,0.2,"[0, 20, 40]",0.0003,0.002,0.001,3
4802,0.007039999999998785,0.46808510638297873,1,9,37,47,39,8,10,17,10,1,0.2,"[0, 20, 40]",0.0003,0.002,0.001,5
4803,0.005889999999999464,0.5294117647058824,1,2,14,17,14,3,10,17,10,1,0.2,"[0, 20, 40]",0.0003,0.002,0.0015,1
4804,0.0016899999999991694,0.3611111111111111,1,4,31,36,29,7,10,17,10,1,0.2,"[0, 20, 40]",0.0003,0.002,0.0015,3
4805,0.003299999999998536,0.3829787234042553,1,5,41,47,39,8,10,17,10,1,0.2,"[0, 20, 40]",0.0003,0.002,0.0015,5
4806,0.002759999999999872,0.8,2,1,2,5,4,1,10,17,10,1,0.2,"[0, 20, 40]",0.0005,0.001,0.001,1
4807,0.0048099999999998665,0.6,5,4,11,20,17,3,10,17,10,1,0.2,"[0, 20, 40]",0.0005,0.001,0.001,3
4808,0.007029999999999158,0.5625,6,6,20,32,29,3,10,17,10,1,0.2,"[0, 20, 40]",0.0005,0.001,0.001,5
4809,0.0032599999999998715,0.8,2,1,2,5,4,1,10,17,10,1,0.2,"[0, 20, 40]",0.0005,0.001,0.0015,1
4810,0.004309999999999754,0.55,5,3,12,20,17,3,10,17,10,1,0.2,"[0, 20, 40]",0.0005,0.001,0.0015,3
4811,0.005589999999998826,0.5,6,4,22,32,29,3,10,17,10,1,0.2,"[0, 20, 40]",0.0005,0.001,0.0015,5
4812,0.002639999999999697,0.6,1,1,3,5,4,1,10,17,10,1,0.2,"[0, 20, 40]",0.0005,0.0015,0.001,1
4813,0.005149999999999652,0.55,2,4,14,20,17,3,10,17,10,1,0.2,"[0, 20, 40]",0.0005,0.0015,0.001,3
4814,0.007249999999998714,0.53125,2,6,24,32,29,3,10,17,10,1,0.2,"[0, 20, 40]",0.0005,0.0015,0.001,5
4815,0.0031399999999996964,0.6,1,1,3,5,4,1,10,17,10,1,0.2,"[0, 20, 40]",0.0005,0.0015,0.0015,1
4816,0.00464999999999954,0.5,2,3,15,20,17,3,10,17,10,1,0.2,"[0, 20, 40]",0.0005,0.0015,0.0015,3
4817,0.005809999999998383,0.46875,2,4,26,32,29,3,10,17,10,1,0.2,"[0, 20, 40]",0.0005,0.0015,0.0015,5
4818,0.003139999999999697,0.6,1,1,3,5,4,1,10,17,10,1,0.2,"[0, 20, 40]",0.0005,0.002,0.001,1
4819,0.004469999999999528,0.5,1,4,15,20,17,3,10,17,10,1,0.2,"[0, 20, 40]",0.0005,0.002,0.001,3
4820,0.006569999999998588,0.5,1,6,25,32,29,3,10,17,10,1,0.2,"[0, 20, 40]",0.0005,0.002,0.001,5
4821,0.0036399999999996964,0.6,1,1,3,5,4,1,10,17,10,1,0.2,"[0, 20, 40]",0.0005,0.002,0.0015,1
4822,0.003969999999999415,0.45,1,3,16,20,17,3,10,17,10,1,0.2,"[0, 20, 40]",0.0005,0.002,0.0015,3
4823,0.005129999999998257,0.4375,1,4,27,32,29,3,10,17,10,1,0.2,"[0, 20, 40]",0.0005,0.002,0.0015,5
4824,0.00404999999999884,0.4444444444444444,4,4,19,27,19,8,10,17,10,2,0.1,"[0, 20, 40]",0.0003,0.001,0.001,1
4825,0.003929999999997961,0.3939393939393939,11,10,45,66,49,17,10,17,10,2,0.1,"[0, 20, 40]",0.0003,0.001,0.001,3
4826,0.009189999999997407,0.43373493975903615,13,14,56,83,65,18,10,17,10,2,0.1,"[0, 20, 40]",0.0003,0.001,0.001,5
4827,0.004629999999998921,0.4074074074074074,4,3,20,27,19,8,10,17,10,2,0.1,"[0, 20, 40]",0.0003,0.001,0.0015,1
4828,0.0048499999999979905,0.36363636363636365,11,8,47,66,49,17,10,17,10,2,0.1,"[0, 20, 40]",0.0003,0.001,0.0015,3
4829,0.007209999999997369,0.3855421686746988,14,9,60,83,65,18,10,17,10,2,0.1,"[0, 20, 40]",0.0003,0.001,0.0015,5
4830,0.004499999999998902,0.4444444444444444,2,5,20,27,19,8,10,17,10,2,0.1,"[0, 20, 40]",0.0003,0.0015,0.001,1
4831,0.0038899999999978158,0.3939393939393939,2,11,53,66,49,17,10,17,10,2,0.1,"[0, 20, 40]",0.0003,0.0015,0.001,3
4832,0.008969999999996972,0.43373493975903615,2,15,66,83,65,18,10,17,10,2,0.1,"[0, 20, 40]",0.0003,0.0015,0.001,5
4833,0.004399999999998857,0.37037037037037035,2,3,22,27,19,8,10,17,10,2,0.1,"[0, 20, 40]",0.0003,0.0015,0.0015,1
4834,0.0041299999999977206,0.3484848484848485,2,8,56,66,49,17,10,17,10,2,0.1,"[0, 20, 40]",0.0003,0.0015,0.0015,3
4835,0.006569999999996624,0.37349397590361444,2,9,72,83,65,18,10,17,10,2,0.1,"[0, 20, 40]",0.0003,0.0015,0.0015,5
4836,0.004939999999999009,0.4444444444444444,1,5,21,27,19,8,10,17,10,2,0.1,"[0, 20, 40]",0.0003,0.002,0.001,1
4837,0.004329999999997924,0.3939393939393939,1,11,54,66,49,17,10,17,10,2,0.1,"[0, 20, 40]",0.0003,0.002,0.001,3
4838,0.009409999999997079,0.43373493975903615,1,15,67,83,65,18,10,17,10,2,0.1,"[0, 20, 40]",0.0003,0.002,0.001,5
4839,0.004839999999998966,0.37037037037037035,1,3,23,27,19,8,10,17,10,2,0.1,"[0, 20, 40]",0.0003,0.002,0.0015,1
4840,0.0045699999999978275,0.3484848484848485,1,8,57,66,49,17,10,17,10,2,0.1,"[0, 20, 40]",0.0003,0.002,0.0015,3
4841,0.007009999999996732,0.37349397590361444,1,9,73,83,65,18,10,17,10,2,0.1,"[0, 20, 40]",0.0003,0.002,0.0015,5
4842,0.00441,0.6363636363636364,4,2,5,11,8,3,10,17,10,2,0.1,"[0, 20, 40]",0.0005,0.001,0.001,1
4843,0.010889999999999681,0.59375,9,8,15,32,26,6,10,17,10,2,0.1,"[0, 20, 40]",0.0005,0.001,0.001,3
4844,0.015119999999998815,0.5714285714285714,13,10,26,49,43,6,10,17,10,2,0.1,"[0, 20, 40]",0.0005,0.001,0.001,5
4845,0.00260999999999992,0.5454545454545454,4,1,6,11,8,3,10,17,10,2,0.1,"[0, 20, 40]",0.0005,0.001,0.0015,1
4846,0.007709999999999441,0.5,9,5,18,32,26,6,10,17,10,2,0.1,"[0, 20, 40]",0.0005,0.001,0.0015,3
4847,0.010999999999998353,0.4897959183673469,13,6,30,49,43,6,10,17,10,2,0.1,"[0, 20, 40]",0.0005,0.001,0.0015,5
4848,0.0028199999999995212,0.45454545454545453,1,2,8,11,8,3,10,17,10,2,0.1,"[0, 20, 40]",0.0005,0.0015,0.001,1
4849,0.01049999999999907,0.53125,3,8,21,32,26,6,10,17,10,2,0.1,"[0, 20, 40]",0.0005,0.0015,0.001,3
4850,0.01606999999999777,0.5306122448979592,5,10,34,49,43,6,10,17,10,2,0.1,"[0, 20, 40]",0.0005,0.0015,0.001,5
4851,0.0010199999999994428,0.36363636363636365,1,1,9,11,8,3,10,17,10,2,0.1,"[0, 20, 40]",0.0005,0.0015,0.0015,1
4852,0.007319999999998834,0.4375,3,5,24,32,26,6,10,17,10,2,0.1,"[0, 20, 40]",0.0005,0.0015,0.0015,3
4853,0.011949999999997312,0.4489795918367347,5,6,38,49,43,6,10,17,10,2,0.1,"[0, 20, 40]",0.0005,0.0015,0.0015,5
4854,0.0033199999999995213,0.45454545454545453,1,2,8,11,8,3,10,17,10,2,0.1,"[0, 20, 40]",0.0005,0.002,0.001,1
4855,0.010679999999998862,0.53125,2,8,22,32,26,6,10,17,10,2,0.1,"[0, 20, 40]",0.0005,0.002,0.001,3
4856,0.016289999999997487,0.5306122448979592,3,10,36,49,43,6,10,17,10,2,0.1,"[0, 20, 40]",0.0005,0.002,0.001,5
4857,0.0015199999999994428,0.36363636363636365,1,1,9,11,8,3,10,17,10,2,0.1,"[0, 20, 40]",0.0005,0.002,0.0015,1
4858,0.007499999999998627,0.4375,2,5,25,32,26,6,10,17,10,2,0.1,"[0, 20, 40]",0.0005,0.002,0.0015,3
4859,0.012169999999997027,0.4489795918367347,3,6,40,49,43,6,10,17,10,2,0.1,"[0, 20, 40]",0.0005,0.002,0.0015,5
4860,0.00302999999999993,0.5833333333333334,3,2,7,12,12,0,10,17,10,2,0.2,"[0, 20, 40]",0.0003,0.001,0.001,1
4861,0.002889999999999743,0.4482758620689655,5,6,18,29,26,3,10,17,10,2,0.2,"[0, 20, 40]",0.0003,0.001,0.001,3
4862,0.007859999999999197,0.525,5,10,25,40,36,4,10,17,10,2,0.2,"[0, 20, 40]",0.0003,0.001,0.001,5
4863,0.0040299999999999295,0.5833333333333334,3,2,7,12,12,0,10,17,10,2,0.2,"[0, 20, 40]",0.0003,0.001,0.0015,1
4864,0.0032299999999996923,0.41379310344827586,5,5,19,29,26,3,10,17,10,2,0.2,"[0, 20, 40]",0.0003,0.001,0.0015,3
4865,0.005299999999999078,0.45,6,6,28,40,36,4,10,17,10,2,0.2,"[0, 20, 40]",0.0003,0.001,0.0015,5
4866,0.0029799999999999913,0.5833333333333334,1,3,8,12,12,0,10,17,10,2,0.2,"[0, 20, 40]",0.0003,0.0015,0.001,1
4867,0.0029699999999997693,0.4482758620689655,1,7,21,29,26,3,10,17,10,2,0.2,"[0, 20, 40]",0.0003,0.0015,0.001,3
4868,0.007939999999999224,0.525,1,11,28,40,36,4,10,17,10,2,0.2,"[0, 20, 40]",0.0003,0.0015,0.001,5
4869,0.003299999999999867,0.5,1,2,9,12,12,0,10,17,10,2,0.2,"[0, 20, 40]",0.0003,0.0015,0.0015,1
4870,0.002629999999999595,0.3793103448275862,1,5,23,29,26,3,10,17,10,2,0.2,"[0, 20, 40]",0.0003,0.0015,0.0015,3
4871,0.004959999999998796,0.425,1,6,33,40,36,4,10,17,10,2,0.2,"[0, 20, 40]",0.0003,0.0015,0.0015,5
4872,0.002920000000000099,0.5833333333333334,0,3,9,12,12,0,10,17,10,2,0.2,"[0, 20, 40]",0.0003,0.002,0.001,1
4873,0.002909999999999877,0.4482758620689655,0,7,22,29,26,3,10,17,10,2,0.2,"[0, 20, 40]",0.0003,0.002,0.001,3
4874,0.007879999999999332,0.525,0,11,29,40,36,4,10,17,10,2,0.2,"[0, 20, 40]",0.0003,0.002,0.001,5
4875,0.0032399999999999747,0.5,0,2,10,12,12,0,10,17,10,2,0.2,"[0, 20, 40]",0.0003,0.002,0.0015,1
4876,0.0025699999999997027,0.3793103448275862,0,5,24,29,26,3,10,17,10,2,0.2,"[0, 20, 40]",0.0003,0.002,0.0015,3
4877,0.0048999999999989035,0.425,0,6,34,40,36,4,10,17,10,2,0.2,"[0, 20, 40]",0.0003,0.002,0.0015,5
4878,0.0006499999999998396,0.5,0,1,3,4,4,0,10,17,10,2,0.2,"[0, 20, 40]",0.0005,0.001,0.001,1
4879,0.002789999999999822,0.5,2,5,9,16,15,1,10,17,10,2,0.2,"[0, 20, 40]",0.0005,0.001,0.001,3
4880,0.005489999999999282,0.5185185185185185,4,7,16,27,26,1,10,17,10,2,0.2,"[0, 20, 40]",0.0005,0.001,0.001,5
4881,0.001149999999999839,0.5,0,1,3,4,4,0,10,17,10,2,0.2,"[0, 20, 40]",0.0005,0.001,0.0015,1
4882,0.0009099999999996631,0.375,2,3,11,16,15,1,10,17,10,2,0.2,"[0, 20, 40]",0.0005,0.001,0.0015,3
4883,0.0026699999999989016,0.4074074074074074,4,4,19,27,26,1,10,17,10,2,0.2,"[0, 20, 40]",0.0005,0.001,0.0015,5
4884,0.0006499999999998396,0.5,0,1,3,4,4,0,10,17,10,2,0.2,"[0, 20, 40]",0.0005,0.0015,0.001,1
4885,0.0032499999999996716,0.5,1,5,10,16,15,1,10,17,10,2,0.2,"[0, 20, 40]",0.0005,0.0015,0.001,3
4886,0.006289999999998696,0.5185185185185185,1,7,19,27,26,1,10,17,10,2,0.2,"[0, 20, 40]",0.0005,0.0015,0.001,5
4887,0.001149999999999839,0.5,0,1,3,4,4,0,10,17,10,2,0.2,"[0, 20, 40]",0.0005,0.0015,0.0015,1
4888,0.0013699999999995129,0.375,1,3,12,16,15,1,10,17,10,2,0.2,"[0, 20, 40]",0.0005,0.0015,0.0015,3
4889,0.003469999999998317,0.4074074074074074,1,4,22,27,26,1,10,17,10,2,0.2,"[0, 20, 40]",0.0005,0.0015,0.0015,5
4890,0.0006499999999998396,0.5,0,1,3,4,4,0,10,17,10,2,0.2,"[0, 20, 40]",0.0005,0.002,0.001,1
4891,0.0037499999999996716,0.5,1,5,10,16,15,1,10,17,10,2,0.2,"[0, 20, 40]",0.0005,0.002,0.001,3
4892,0.006789999999998696,0.5185185185185185,1,7,19,27,26,1,10,17,10,2,0.2,"[0, 20, 40]",0.0005,0.002,0.001,5
4893,0.001149999999999839,0.5,0,1,3,4,4,0,10,17,10,2,0.2,"[0, 20, 40]",0.0005,0.002,0.0015,1
4894,0.0018699999999995122,0.375,1,3,12,16,15,1,10,17,10,2,0.2,"[0, 20, 40]",0.0005,0.002,0.0015,3
4895,0.003969999999998316,0.4074074074074074,1,4,22,27,26,1,10,17,10,2,0.2,"[0, 20, 40]",0.0005,0.002,0.0015,5
4896,0.01025999999999882,0.6,8,9,18,35,20,15,10,17,15,1,0.1,"[0, 20, 40]",0.0003,0.001,0.001,1
4897,0.01916999999999751,0.5584415584415584,17,19,41,77,47,30,10,17,15,1,0.1,"[0, 20, 40]",0.0003,0.001,0.001,3
4898,0.02544999999999686,0.5555555555555556,21,23,55,99,67,32,10,17,15,1,0.1,"[0, 20, 40]",0.0003,0.001,0.001,5
4899,0.0036899999999986896,0.4857142857142857,9,3,23,35,20,15,10,17,15,1,0.1,"[0, 20, 40]",0.0003,0.001,0.0015,1
4900,0.009179999999997076,0.45454545454545453,18,9,50,77,47,30,10,17,15,1,0.1,"[0, 20, 40]",0.0003,0.001,0.0015,3
4901,0.01429999999999659,0.46464646464646464,23,11,65,99,67,32,10,17,15,1,0.1,"[0, 20, 40]",0.0003,0.001,0.0015,5
4902,0.012739999999998797,0.6,5,11,19,35,20,15,10,17,15,1,0.1,"[0, 20, 40]",0.0003,0.0015,0.001,1
4903,0.022169999999997237,0.5454545454545454,9,21,47,77,47,30,10,17,15,1,0.1,"[0, 20, 40]",0.0003,0.0015,0.001,3
4904,0.028529999999996454,0.5454545454545454,9,25,65,99,67,32,10,17,15,1,0.1,"[0, 20, 40]",0.0003,0.0015,0.001,5
4905,0.0071699999999985595,0.4857142857142857,7,3,25,35,20,15,10,17,15,1,0.1,"[0, 20, 40]",0.0003,0.0015,0.0015,1
4906,0.01317999999999668,0.44155844155844154,11,9,57,77,47,30,10,17,15,1,0.1,"[0, 20, 40]",0.0003,0.0015,0.0015,3
4907,0.018879999999996084,0.45454545454545453,12,11,76,99,67,32,10,17,15,1,0.1,"[0, 20, 40]",0.0003,0.0015,0.0015,5
4908,0.012769999999998833,0.5714285714285714,3,11,21,35,20,15,10,17,15,1,0.1,"[0, 20, 40]",0.0003,0.002,0.001,1
4909,0.02358999999999727,0.5324675324675324,6,21,50,77,47,30,10,17,15,1,0.1,"[0, 20, 40]",0.0003,0.002,0.001,3
4910,0.029949999999996497,0.5353535353535354,6,25,68,99,67,32,10,17,15,1,0.1,"[0, 20, 40]",0.0003,0.002,0.001,5
4911,0.007619999999998793,0.45714285714285713,3,3,29,35,20,15,10,17,15,1,0.1,"[0, 20, 40]",0.0003,0.002,0.0015,1
4912,0.015019999999996909,0.42857142857142855,6,9,62,77,47,30,10,17,15,1,0.1,"[0, 20, 40]",0.0003,0.002,0.0015,3
4913,0.021219999999996336,0.4444444444444444,7,11,81,99,67,32,10,17,15,1,0.1,"[0, 20, 40]",0.0003,0.002,0.0015,5
4914,0.006349999999999874,0.8888888888888888,6,2,1,9,5,4,10,17,15,1,0.1,"[0, 20, 40]",0.0005,0.001,0.001,1
4915,0.01856999999999927,0.7777777777777778,14,11,11,36,23,13,10,17,15,1,0.1,"[0, 20, 40]",0.0005,0.001,0.001,3
4916,0.022399999999998338,0.6551724137931034,20,13,25,58,44,14,10,17,15,1,0.1,"[0, 20, 40]",0.0005,0.001,0.001,5
4917,0.004049999999999793,0.7777777777777778,7,0,2,9,5,4,10,17,15,1,0.1,"[0, 20, 40]",0.0005,0.001,0.0015,1
4918,0.011569999999999102,0.6388888888888888,15,5,16,36,23,13,10,17,15,1,0.1,"[0, 20, 40]",0.0005,0.001,0.0015,3
4919,0.01639999999999817,0.5689655172413793,21,7,30,58,44,14,10,17,15,1,0.1,"[0, 20, 40]",0.0005,0.001,0.0015,5
4920,0.0037199999999994664,0.6666666666666666,1,2,6,9,5,4,10,17,15,1,0.1,"[0, 20, 40]",0.0005,0.0015,0.001,1
4921,0.018329999999998705,0.7222222222222222,6,11,19,36,23,13,10,17,15,1,0.1,"[0, 20, 40]",0.0005,0.0015,0.001,3
4922,0.02413999999999742,0.6206896551724138,10,13,35,58,44,14,10,17,15,1,0.1,"[0, 20, 40]",0.0005,0.0015,0.001,5
4923,0.0019199999999993875,0.5555555555555556,2,0,7,9,5,4,10,17,15,1,0.1,"[0, 20, 40]",0.0005,0.0015,0.0015,1
4924,0.011829999999998531,0.5833333333333334,7,5,24,36,23,13,10,17,15,1,0.1,"[0, 20, 40]",0.0005,0.0015,0.0015,3
4925,0.018639999999997253,0.5344827586206896,11,7,40,58,44,14,10,17,15,1,0.1,"[0, 20, 40]",0.0005,0.0015,0.0015,5
4926,0.004219999999999466,0.6666666666666666,1,2,6,9,5,4,10,17,15,1,0.1,"[0, 20, 40]",0.0005,0.002,0.001,1
4927,0.019599999999998695,0.7222222222222222,4,11,21,36,23,13,10,17,15,1,0.1,"[0, 20, 40]",0.0005,0.002,0.001,3
4928,0.024749999999997312,0.603448275862069,6,13,39,58,44,14,10,17,15,1,0.1,"[0, 20, 40]",0.0005,0.002,0.001,5
4929,0.0029199999999993875,0.5555555555555556,2,0,7,9,5,4,10,17,15,1,0.1,"[0, 20, 40]",0.0005,0.002,0.0015,1
4930,0.013599999999998526,0.5833333333333334,5,5,26,36,23,13,10,17,15,1,0.1,"[0, 20, 40]",0.0005,0.002,0.0015,3
4931,0.019749999999997145,0.5172413793103449,7,7,44,58,44,14,10,17,15,1,0.1,"[0, 20, 40]",0.0005,0.002,0.0015,5
4932,0.00453999999999954,0.6,5,2,8,15,12,3,10,17,15,1,0.2,"[0, 20, 40]",0.0003,0.001,0.001,1
4933,0.005019999999998376,0.47058823529411764,7,5,22,34,27,7,10,17,15,1,0.2,"[0, 20, 40]",0.0003,0.001,0.001,3
4934,0.010169999999998347,0.5111111111111111,10,8,27,45,37,8,10,17,15,1,0.2,"[0, 20, 40]",0.0003,0.001,0.001,5
4935,0.0026999999999996432,0.5333333333333333,5,1,9,15,12,3,10,17,15,1,0.2,"[0, 20, 40]",0.0003,0.001,0.0015,1
4936,0.002669999999998245,0.4117647058823529,7,3,24,34,27,7,10,17,15,1,0.2,"[0, 20, 40]",0.0003,0.001,0.0015,3
4937,0.006659999999998385,0.4444444444444444,10,5,30,45,37,8,10,17,15,1,0.2,"[0, 20, 40]",0.0003,0.001,0.0015,5
4938,0.006539999999999541,0.6,4,3,8,15,12,3,10,17,15,1,0.2,"[0, 20, 40]",0.0003,0.0015,0.001,1
4939,0.007239999999998268,0.47058823529411764,4,6,24,34,27,7,10,17,15,1,0.2,"[0, 20, 40]",0.0003,0.0015,0.001,3
4940,0.012529999999998149,0.5111111111111111,4,9,32,45,37,8,10,17,15,1,0.2,"[0, 20, 40]",0.0003,0.0015,0.001,5
4941,0.004699999999999535,0.5333333333333333,4,1,10,15,12,3,10,17,15,1,0.2,"[0, 20, 40]",0.0003,0.0015,0.0015,1
4942,0.004889999999998026,0.4117647058823529,4,3,27,34,27,7,10,17,15,1,0.2,"[0, 20, 40]",0.0003,0.0015,0.0015,3
4943,0.00901999999999808,0.4444444444444444,4,5,36,45,37,8,10,17,15,1,0.2,"[0, 20, 40]",0.0003,0.0015,0.0015,5
4944,0.006069999999999572,0.5333333333333333,2,3,10,15,12,3,10,17,15,1,0.2,"[0, 20, 40]",0.0003,0.002,0.001,1
4945,0.006769999999998298,0.4411764705882353,2,6,26,34,27,7,10,17,15,1,0.2,"[0, 20, 40]",0.0003,0.002,0.001,3
4946,0.012059999999998182,0.4888888888888889,2,9,34,45,37,8,10,17,15,1,0.2,"[0, 20, 40]",0.0003,0.002,0.001,5
4947,0.004229999999999566,0.4666666666666667,2,1,12,15,12,3,10,17,15,1,0.2,"[0, 20, 40]",0.0003,0.002,0.0015,1
4948,0.004419999999998055,0.38235294117647056,2,3,29,34,27,7,10,17,15,1,0.2,"[0, 20, 40]",0.0003,0.002,0.0015,3
4949,0.008549999999998116,0.4222222222222222,2,5,38,45,37,8,10,17,15,1,0.2,"[0, 20, 40]",0.0003,0.002,0.0015,5
4950,0.0023499999999998726,0.75,3,0,1,4,3,1,10,17,15,1,0.2,"[0, 20, 40]",0.0005,0.001,0.001,1
4951,0.00793999999999952,0.6842105263157895,6,5,8,19,16,3,10,17,15,1,0.2,"[0, 20, 40]",0.0005,0.001,0.001,3
4952,0.00934999999999872,0.5483870967741935,8,7,16,31,28,3,10,17,15,1,0.2,"[0, 20, 40]",0.0005,0.001,0.001,5
4953,0.0023499999999998726,0.75,3,0,1,4,3,1,10,17,15,1,0.2,"[0, 20, 40]",0.0005,0.001,0.0015,1
4954,0.006159999999999351,0.5789473684210527,6,3,10,19,16,3,10,17,15,1,0.2,"[0, 20, 40]",0.0005,0.001,0.0015,3
4955,0.008569999999998548,0.4838709677419355,8,5,18,31,28,3,10,17,15,1,0.2,"[0, 20, 40]",0.0005,0.001,0.0015,5
4956,0.001099999999999512,0.5,1,0,3,4,3,1,10,17,15,1,0.2,"[0, 20, 40]",0.0005,0.0015,0.001,1
4957,0.007939999999999134,0.631578947368421,3,5,11,19,16,3,10,17,15,1,0.2,"[0, 20, 40]",0.0005,0.0015,0.001,3
4958,0.010009999999998161,0.5161290322580645,4,7,20,31,28,3,10,17,15,1,0.2,"[0, 20, 40]",0.0005,0.0015,0.001,5
4959,0.001099999999999512,0.5,1,0,3,4,3,1,10,17,15,1,0.2,"[0, 20, 40]",0.0005,0.0015,0.0015,1
4960,0.0061599999999989614,0.5263157894736842,3,3,13,19,16,3,10,17,15,1,0.2,"[0, 20, 40]",0.0005,0.0015,0.0015,3
4961,0.009229999999997988,0.45161290322580644,4,5,22,31,28,3,10,17,15,1,0.2,"[0, 20, 40]",0.0005,0.0015,0.0015,5
4962,0.001599999999999512,0.5,1,0,3,4,3,1,10,17,15,1,0.2,"[0, 20, 40]",0.0005,0.002,0.001,1
4963,0.0077099999999991255,0.631578947368421,1,5,13,19,16,3,10,17,15,1,0.2,"[0, 20, 40]",0.0005,0.002,0.001,3
4964,0.009459999999998114,0.5161290322580645,1,7,23,31,28,3,10,17,15,1,0.2,"[0, 20, 40]",0.0005,0.002,0.001,5
4965,0.001599999999999512,0.5,1,0,3,4,3,1,10,17,15,1,0.2,"[0, 20, 40]",0.0005,0.002,0.0015,1
4966,0.0059299999999989535,0.5263157894736842,1,3,15,19,16,3,10,17,15,1,0.2,"[0, 20, 40]",0.0005,0.002,0.0015,3
4967,0.008679999999997943,0.45161290322580644,1,5,25,31,28,3,10,17,15,1,0.2,"[0, 20, 40]",0.0005,0.002,0.0015,5
4968,0.000989999999999156,0.4,4,3,18,25,17,8,10,17,15,2,0.1,"[0, 20, 40]",0.0003,0.001,0.001,1
4969,0.007209999999998091,0.4603174603174603,12,12,39,63,46,17,10,17,15,2,0.1,"[0, 20, 40]",0.0003,0.001,0.001,3
4970,0.013469999999997857,0.4875,16,16,48,80,62,18,10,17,15,2,0.1,"[0, 20, 40]",0.0003,0.001,0.001,5
4971,0.0014099999999992435,0.4,4,2,19,25,17,8,10,17,15,2,0.1,"[0, 20, 40]",0.0003,0.001,0.0015,1
4972,0.007689999999997845,0.42857142857142855,12,9,42,63,46,17,10,17,15,2,0.1,"[0, 20, 40]",0.0003,0.001,0.0015,3
4973,0.01278999999999778,0.45,17,11,52,80,62,18,10,17,15,2,0.1,"[0, 20, 40]",0.0003,0.001,0.0015,5
4974,0.0019699999999991365,0.4,2,4,19,25,17,8,10,17,15,2,0.1,"[0, 20, 40]",0.0003,0.0015,0.001,1
4975,0.009289999999997729,0.4444444444444444,6,13,44,63,46,17,10,17,15,2,0.1,"[0, 20, 40]",0.0003,0.0015,0.001,3
4976,0.015629999999997354,0.475,6,17,57,80,62,18,10,17,15,2,0.1,"[0, 20, 40]",0.0003,0.0015,0.001,5
4977,0.002389999999999114,0.4,2,2,21,25,17,8,10,17,15,2,0.1,"[0, 20, 40]",0.0003,0.0015,0.0015,1
4978,0.009769999999997373,0.4126984126984127,6,9,48,63,46,17,10,17,15,2,0.1,"[0, 20, 40]",0.0003,0.0015,0.0015,3
4979,0.015449999999997166,0.4375,7,11,62,80,62,18,10,17,15,2,0.1,"[0, 20, 40]",0.0003,0.0015,0.0015,5
4980,0.0029699999999991365,0.4,2,4,19,25,17,8,10,17,15,2,0.1,"[0, 20, 40]",0.0003,0.002,0.001,1
4981,0.01167999999999773,0.4444444444444444,5,13,45,63,46,17,10,17,15,2,0.1,"[0, 20, 40]",0.0003,0.002,0.001,3
4982,0.018019999999997358,0.475,5,17,58,80,62,18,10,17,15,2,0.1,"[0, 20, 40]",0.0003,0.002,0.001,5
4983,0.0033899999999991138,0.4,2,2,21,25,17,8,10,17,15,2,0.1,"[0, 20, 40]",0.0003,0.002,0.0015,1
4984,0.01215999999999737,0.4126984126984127,5,9,49,63,46,17,10,17,15,2,0.1,"[0, 20, 40]",0.0003,0.002,0.0015,3
4985,0.01833999999999717,0.4375,6,11,63,80,62,18,10,17,15,2,0.1,"[0, 20, 40]",0.0003,0.002,0.0015,5
4986,0.005159999999999939,0.7,6,1,3,10,7,3,10,17,15,2,0.1,"[0, 20, 40]",0.0005,0.001,0.001,1
4987,0.015729999999999435,0.7419354838709677,12,9,10,31,25,6,10,17,15,2,0.1,"[0, 20, 40]",0.0005,0.001,0.001,3
4988,0.02060999999999872,0.6666666666666666,17,11,20,48,42,6,10,17,15,2,0.1,"[0, 20, 40]",0.0005,0.001,0.001,5
4989,0.0028599999999998587,0.6,6,0,4,10,7,3,10,17,15,2,0.1,"[0, 20, 40]",0.0005,0.001,0.0015,1
4990,0.010649999999999073,0.6129032258064516,12,5,14,31,25,6,10,17,15,2,0.1,"[0, 20, 40]",0.0005,0.001,0.0015,3
4991,0.016529999999998355,0.5833333333333334,17,7,24,48,42,6,10,17,15,2,0.1,"[0, 20, 40]",0.0005,0.001,0.0015,5
4992,0.0025299999999995318,0.5,1,1,8,10,7,3,10,17,15,2,0.1,"[0, 20, 40]",0.0005,0.0015,0.001,1
4993,0.014489999999998863,0.6774193548387096,4,9,18,31,25,6,10,17,15,2,0.1,"[0, 20, 40]",0.0005,0.0015,0.001,3
4994,0.02152999999999798,0.625,8,11,29,48,42,6,10,17,15,2,0.1,"[0, 20, 40]",0.0005,0.0015,0.001,5
4995,0.00022999999999945308,0.4,1,0,9,10,7,3,10,17,15,2,0.1,"[0, 20, 40]",0.0005,0.0015,0.0015,1
4996,0.009409999999998505,0.5483870967741935,4,5,22,31,25,6,10,17,15,2,0.1,"[0, 20, 40]",0.0005,0.0015,0.0015,3
4997,0.01744999999999761,0.5416666666666666,8,7,33,48,42,6,10,17,15,2,0.1,"[0, 20, 40]",0.0005,0.0015,0.0015,5
4998,0.0030299999999995318,0.5,1,1,8,10,7,3,10,17,15,2,0.1,"[0, 20, 40]",0.0005,0.002,0.001,1
4999,0.01588999999999893,0.6774193548387096,3,9,19,31,25,6,10,17,15,2,0.1,"[0, 20, 40]",0.0005,0.002,0.001,3
5000,0.022269999999997944,0.6041666666666666,5,11,32,48,42,6,10,17,15,2,0.1,"[0, 20, 40]",0.0005,0.002,0.001,5
5001,0.0007299999999994531,0.4,1,0,9,10,7,3,10,17,15,2,0.1,"[0, 20, 40]",0.0005,0.002,0.0015,1
5002,0.010809999999998569,0.5483870967741935,3,5,23,31,25,6,10,17,15,2,0.1,"[0, 20, 40]",0.0005,0.002,0.0015,3
5003,0.018189999999997576,0.5208333333333334,5,7,36,48,42,6,10,17,15,2,0.1,"[0, 20, 40]",0.0005,0.002,0.0015,5
5004,0.0011999999999999782,0.4,2,1,7,10,10,0,10,17,15,2,0.2,"[0, 20, 40]",0.0003,0.001,0.001,1
5005,0.004929999999999607,0.48148148148148145,4,7,16,27,24,3,10,17,15,2,0.2,"[0, 20, 40]",0.0003,0.001,0.001,3
5006,0.010739999999999455,0.5526315789473685,6,11,21,38,34,4,10,17,15,2,0.2,"[0, 20, 40]",0.0003,0.001,0.001,5
5007,0.0016999999999999782,0.4,2,1,7,10,10,0,10,17,15,2,0.2,"[0, 20, 40]",0.0003,0.001,0.0015,1
5008,0.003989999999999276,0.4074074074074074,4,5,18,27,24,3,10,17,15,2,0.2,"[0, 20, 40]",0.0003,0.001,0.0015,3
5009,0.008639999999999296,0.47368421052631576,7,7,24,38,34,4,10,17,15,2,0.2,"[0, 20, 40]",0.0003,0.001,0.0015,5
5010,0.001699999999999978,0.4,1,2,7,10,10,0,10,17,15,2,0.2,"[0, 20, 40]",0.0003,0.0015,0.001,1
5011,0.004909999999999476,0.4444444444444444,2,8,17,27,24,3,10,17,15,2,0.2,"[0, 20, 40]",0.0003,0.0015,0.001,3
5012,0.010879999999999484,0.5263157894736842,2,12,24,38,34,4,10,17,15,2,0.2,"[0, 20, 40]",0.0003,0.0015,0.001,5
5013,0.002199999999999868,0.4,1,1,8,10,10,0,10,17,15,2,0.2,"[0, 20, 40]",0.0003,0.0015,0.0015,1
5014,0.003969999999999035,0.37037037037037035,2,5,20,27,24,3,10,17,15,2,0.2,"[0, 20, 40]",0.0003,0.0015,0.0015,3
5015,0.009279999999999216,0.4473684210526316,3,7,28,38,34,4,10,17,15,2,0.2,"[0, 20, 40]",0.0003,0.0015,0.0015,5
5016,0.002199999999999978,0.4,1,2,7,10,10,0,10,17,15,2,0.2,"[0, 20, 40]",0.0003,0.002,0.001,1
5017,0.0059099999999994764,0.4444444444444444,2,8,17,27,24,3,10,17,15,2,0.2,"[0, 20, 40]",0.0003,0.002,0.001,3
5018,0.011879999999999486,0.5263157894736842,2,12,24,38,34,4,10,17,15,2,0.2,"[0, 20, 40]",0.0003,0.002,0.001,5
5019,0.002699999999999868,0.4,1,1,8,10,10,0,10,17,15,2,0.2,"[0, 20, 40]",0.0003,0.002,0.0015,1
5020,0.004969999999999036,0.37037037037037035,2,5,20,27,24,3,10,17,15,2,0.2,"[0, 20, 40]",0.0003,0.002,0.0015,3
5021,0.010779999999999212,0.4473684210526316,3,7,28,38,34,4,10,17,15,2,0.2,"[0, 20, 40]",0.0003,0.002,0.0015,5
5022,0.0005499999999998725,0.3333333333333333,1,0,2,3,3,0,10,17,15,2,0.2,"[0, 20, 40]",0.0005,0.001,0.001,1
5023,0.005859999999999641,0.6666666666666666,3,5,7,15,14,1,10,17,15,2,0.2,"[0, 20, 40]",0.0005,0.001,0.001,3
5024,0.008859999999999172,0.5769230769230769,6,7,13,26,25,1,10,17,15,2,0.2,"[0, 20, 40]",0.0005,0.001,0.001,5
5025,0.0005499999999998725,0.3333333333333333,1,0,2,3,3,0,10,17,15,2,0.2,"[0, 20, 40]",0.0005,0.001,0.0015,1
5026,0.0044599999999992935,0.5333333333333333,3,3,9,15,14,1,10,17,15,2,0.2,"[0, 20, 40]",0.0005,0.001,0.0015,3
5027,0.008459999999998826,0.5,6,5,15,26,25,1,10,17,15,2,0.2,"[0, 20, 40]",0.0005,0.001,0.0015,5
5028,0.0004999999999996569,0.3333333333333333,0,0,3,3,3,0,10,17,15,2,0.2,"[0, 20, 40]",0.0005,0.0015,0.001,1
5029,0.006559999999999398,0.6666666666666666,1,5,9,15,14,1,10,17,15,2,0.2,"[0, 20, 40]",0.0005,0.0015,0.001,3
5030,0.010719999999998757,0.5769230769230769,3,7,16,26,25,1,10,17,15,2,0.2,"[0, 20, 40]",0.0005,0.0015,0.001,5
5031,0.0004999999999996569,0.3333333333333333,0,0,3,3,3,0,10,17,15,2,0.2,"[0, 20, 40]",0.0005,0.0015,0.0015,1
5032,0.005159999999999051,0.5333333333333333,1,3,11,15,14,1,10,17,15,2,0.2,"[0, 20, 40]",0.0005,0.0015,0.0015,3
5033,0.01031999999999841,0.5,3,5,18,26,25,1,10,17,15,2,0.2,"[0, 20, 40]",0.0005,0.0015,0.0015,5
5034,0.0004999999999996569,0.3333333333333333,0,0,3,3,3,0,10,17,15,2,0.2,"[0, 20, 40]",0.0005,0.002,0.001,1
5035,0.007059999999999398,0.6666666666666666,1,5,9,15,14,1,10,17,15,2,0.2,"[0, 20, 40]",0.0005,0.002,0.001,3
5036,0.011399999999998715,0.5769230769230769,2,7,17,26,25,1,10,17,15,2,0.2,"[0, 20, 40]",0.0005,0.002,0.001,5
5037,0.0004999999999996569,0.3333333333333333,0,0,3,3,3,0,10,17,15,2,0.2,"[0, 20, 40]",0.0005,0.002,0.0015,1
5038,0.005659999999999051,0.5333333333333333,1,3,11,15,14,1,10,17,15,2,0.2,"[0, 20, 40]",0.0005,0.002,0.0015,3
5039,0.010999999999998369,0.5,2,5,19,26,25,1,10,17,15,2,0.2,"[0, 20, 40]",0.0005,0.002,0.0015,5
5040,0.01750999999999981,0.6764705882352942,11,11,12,34,20,14,10,17,20,1,0.1,"[0, 20, 40]",0.0003,0.001,0.001,1
5041,0.027269999999998993,0.6428571428571429,21,21,28,70,44,26,10,17,20,1,0.1,"[0, 20, 40]",0.0003,0.001,0.001,3
5042,0.03619999999999841,0.6593406593406593,28,26,37,91,63,28,10,17,20,1,0.1,"[0, 20, 40]",0.0003,0.001,0.001,5
5043,0.016820000000000012,0.5882352941176471,12,7,15,34,20,14,10,17,20,1,0.1,"[0, 20, 40]",0.0003,0.001,0.0015,1
5044,0.019419999999999195,0.5142857142857142,21,12,37,70,44,26,10,17,20,1,0.1,"[0, 20, 40]",0.0003,0.001,0.0015,3
5045,0.030969999999998665,0.5714285714285714,29,16,46,91,62,29,10,17,20,1,0.1,"[0, 20, 40]",0.0003,0.001,0.0015,5
5046,0.02012999999999965,0.6764705882352942,6,13,15,34,20,14,10,17,20,1,0.1,"[0, 20, 40]",0.0003,0.0015,0.001,1
5047,0.028529999999998303,0.6,9,24,37,70,44,26,10,17,20,1,0.1,"[0, 20, 40]",0.0003,0.0015,0.001,3
5048,0.03852999999999731,0.6263736263736264,13,29,49,91,63,28,10,17,20,1,0.1,"[0, 20, 40]",0.0003,0.0015,0.001,5
5049,0.02093999999999985,0.5882352941176471,9,7,18,34,20,14,10,17,20,1,0.1,"[0, 20, 40]",0.0003,0.0015,0.0015,1
5050,0.022179999999998513,0.4714285714285714,11,13,46,70,44,26,10,17,20,1,0.1,"[0, 20, 40]",0.0003,0.0015,0.0015,3
5051,0.03529999999999757,0.5384615384615384,16,17,58,91,62,29,10,17,20,1,0.1,"[0, 20, 40]",0.0003,0.0015,0.0015,5
5052,0.020419999999999446,0.6764705882352942,3,13,18,34,20,14,10,17,20,1,0.1,"[0, 20, 40]",0.0003,0.002,0.001,1
5053,0.030369999999998204,0.6,6,24,40,70,44,26,10,17,20,1,0.1,"[0, 20, 40]",0.0003,0.002,0.001,3
5054,0.03879999999999706,0.6222222222222222,7,28,55,90,63,27,10,17,20,1,0.1,"[0, 20, 40]",0.0003,0.002,0.001,5
5055,0.0219399999999998,0.5882352941176471,5,7,22,34,20,14,10,17,20,1,0.1,"[0, 20, 40]",0.0003,0.002,0.0015,1
5056,0.025019999999998408,0.4714285714285714,8,13,49,70,44,26,10,17,20,1,0.1,"[0, 20, 40]",0.0003,0.002,0.0015,3
5057,0.03656999999999732,0.5333333333333333,10,16,64,90,62,28,10,17,20,1,0.1,"[0, 20, 40]",0.0003,0.002,0.0015,5
5058,0.006289999999999924,0.8888888888888888,6,2,1,9,5,4,10,17,20,1,0.1,"[0, 20, 40]",0.0005,0.001,0.001,1
5059,0.016749999999999852,0.7575757575757576,13,10,10,33,22,11,10,17,20,1,0.1,"[0, 20, 40]",0.0005,0.001,0.001,3
5060,0.02411999999999912,0.6909090909090909,20,14,21,55,43,12,10,17,20,1,0.1,"[0, 20, 40]",0.0005,0.001,0.001,5
5061,0.004649999999999727,0.7777777777777778,7,0,2,9,5,4,10,17,20,1,0.1,"[0, 20, 40]",0.0005,0.001,0.0015,1
5062,0.015459999999999616,0.6666666666666666,14,6,13,33,22,11,10,17,20,1,0.1,"[0, 20, 40]",0.0005,0.001,0.0015,3
5063,0.02256999999999879,0.6181818181818182,21,9,25,55,43,12,10,17,20,1,0.1,"[0, 20, 40]",0.0005,0.001,0.0015,5
5064,0.0072399999999997675,0.6666666666666666,1,3,5,9,5,4,10,17,20,1,0.1,"[0, 20, 40]",0.0005,0.0015,0.001,1
5065,0.019479999999999643,0.696969696969697,6,11,16,33,22,11,10,17,20,1,0.1,"[0, 20, 40]",0.0005,0.0015,0.001,3
5066,0.028599999999998495,0.6545454545454545,10,15,30,55,43,12,10,17,20,1,0.1,"[0, 20, 40]",0.0005,0.0015,0.001,5
5067,0.004279999999999527,0.4444444444444444,2,0,7,9,5,4,10,17,20,1,0.1,"[0, 20, 40]",0.0005,0.0015,0.0015,1
5068,0.016869999999999354,0.5757575757575758,7,6,20,33,22,11,10,17,20,1,0.1,"[0, 20, 40]",0.0005,0.0015,0.0015,3
5069,0.025729999999998126,0.5636363636363636,11,9,35,55,43,12,10,17,20,1,0.1,"[0, 20, 40]",0.0005,0.0015,0.0015,5
5070,0.007739999999999768,0.6666666666666666,1,3,5,9,5,4,10,17,20,1,0.1,"[0, 20, 40]",0.0005,0.002,0.001,1
5071,0.02175999999999959,0.696969696969697,5,11,17,33,22,11,10,17,20,1,0.1,"[0, 20, 40]",0.0005,0.002,0.001,3
5072,0.030439999999998003,0.6545454545454545,7,15,33,55,43,12,10,17,20,1,0.1,"[0, 20, 40]",0.0005,0.002,0.001,5
5073,0.005279999999999527,0.4444444444444444,2,0,7,9,5,4,10,17,20,1,0.1,"[0, 20, 40]",0.0005,0.002,0.0015,1
5074,0.019649999999999307,0.5757575757575758,6,6,21,33,22,11,10,17,20,1,0.1,"[0, 20, 40]",0.0005,0.002,0.0015,3
5075,0.028069999999997635,0.5636363636363636,8,9,38,55,43,12,10,17,20,1,0.1,"[0, 20, 40]",0.0005,0.002,0.0015,5
5076,0.006919999999999922,0.6666666666666666,7,3,5,15,12,3,10,17,20,1,0.2,"[0, 20, 40]",0.0003,0.001,0.001,1
5077,0.009049999999999598,0.5757575757575758,10,7,16,33,26,7,10,17,20,1,0.2,"[0, 20, 40]",0.0003,0.001,0.001,3
5078,0.014949999999999495,0.627906976744186,14,10,19,43,35,8,10,17,20,1,0.2,"[0, 20, 40]",0.0003,0.001,0.001,5
5079,0.00841999999999992,0.6666666666666666,7,3,5,15,12,3,10,17,20,1,0.2,"[0, 20, 40]",0.0003,0.001,0.0015,1
5080,0.008319999999999531,0.5151515151515151,10,5,18,33,26,7,10,17,20,1,0.2,"[0, 20, 40]",0.0003,0.001,0.0015,3
5081,0.015719999999999425,0.5813953488372093,14,8,21,43,35,8,10,17,20,1,0.2,"[0, 20, 40]",0.0003,0.001,0.0015,5
5082,0.00904999999999983,0.6666666666666666,5,4,6,15,12,3,10,17,20,1,0.2,"[0, 20, 40]",0.0003,0.0015,0.001,1
5083,0.011389999999999215,0.5757575757575758,5,8,20,33,26,7,10,17,20,1,0.2,"[0, 20, 40]",0.0003,0.0015,0.001,3
5084,0.017709999999998866,0.627906976744186,7,11,25,43,35,8,10,17,20,1,0.2,"[0, 20, 40]",0.0003,0.0015,0.001,5
5085,0.011049999999999827,0.6666666666666666,6,3,6,15,12,3,10,17,20,1,0.2,"[0, 20, 40]",0.0003,0.0015,0.0015,1
5086,0.01115999999999915,0.5151515151515151,6,5,22,33,26,7,10,17,20,1,0.2,"[0, 20, 40]",0.0003,0.0015,0.0015,3
5087,0.018979999999998796,0.5813953488372093,8,8,27,43,35,8,10,17,20,1,0.2,"[0, 20, 40]",0.0003,0.0015,0.0015,5
5088,0.008839999999999624,0.6666666666666666,2,4,9,15,12,3,10,17,20,1,0.2,"[0, 20, 40]",0.0003,0.002,0.001,1
5089,0.012219999999999157,0.5757575757575758,3,8,22,33,26,7,10,17,20,1,0.2,"[0, 20, 40]",0.0003,0.002,0.001,3
5090,0.016749999999998655,0.6190476190476191,3,10,29,42,35,7,10,17,20,1,0.2,"[0, 20, 40]",0.0003,0.002,0.001,5
5091,0.011339999999999621,0.6666666666666666,3,3,9,15,12,3,10,17,20,1,0.2,"[0, 20, 40]",0.0003,0.002,0.0015,1
5092,0.012489999999999094,0.5151515151515151,4,5,24,33,26,7,10,17,20,1,0.2,"[0, 20, 40]",0.0003,0.002,0.0015,3
5093,0.018019999999998586,0.5714285714285714,4,7,31,42,35,7,10,17,20,1,0.2,"[0, 20, 40]",0.0003,0.002,0.0015,5
5094,0.0022899999999999236,0.75,3,0,1,4,3,1,10,17,20,1,0.2,"[0, 20, 40]",0.0005,0.001,0.001,1
5095,0.008239999999999931,0.6842105263157895,6,5,8,19,16,3,10,17,20,1,0.2,"[0, 20, 40]",0.0005,0.001,0.001,3
5096,0.012079999999999506,0.6451612903225806,9,8,14,31,28,3,10,17,20,1,0.2,"[0, 20, 40]",0.0005,0.001,0.001,5
5097,0.0022899999999999236,0.75,3,0,1,4,3,1,10,17,20,1,0.2,"[0, 20, 40]",0.0005,0.001,0.0015,1
5098,0.009229999999999865,0.631578947368421,6,4,9,19,16,3,10,17,20,1,0.2,"[0, 20, 40]",0.0005,0.001,0.0015,3
5099,0.012309999999999344,0.5806451612903226,9,6,16,31,28,3,10,17,20,1,0.2,"[0, 20, 40]",0.0005,0.001,0.0015,5
5100,0.00261999999999981,0.75,1,1,2,4,3,1,10,17,20,1,0.2,"[0, 20, 40]",0.0005,0.0015,0.001,1
5101,0.010069999999999819,0.6842105263157895,4,6,9,19,16,3,10,17,20,1,0.2,"[0, 20, 40]",0.0005,0.0015,0.001,3
5102,0.014169999999999152,0.6451612903225806,5,9,17,31,28,3,10,17,20,1,0.2,"[0, 20, 40]",0.0005,0.0015,0.001,5
5103,0.0007999999999997668,0.5,1,0,3,4,3,1,10,17,20,1,0.2,"[0, 20, 40]",0.0005,0.0015,0.0015,1
5104,0.009239999999999707,0.5789473684210527,4,4,11,19,16,3,10,17,20,1,0.2,"[0, 20, 40]",0.0005,0.0015,0.0015,3
5105,0.01257999999999895,0.5483870967741935,5,6,20,31,28,3,10,17,20,1,0.2,"[0, 20, 40]",0.0005,0.0015,0.0015,5
5106,0.00311999999999981,0.75,1,1,2,4,3,1,10,17,20,1,0.2,"[0, 20, 40]",0.0005,0.002,0.001,1
5107,0.011349999999999765,0.6842105263157895,3,6,10,19,16,3,10,17,20,1,0.2,"[0, 20, 40]",0.0005,0.002,0.001,3
5108,0.014729999999998881,0.6451612903225806,3,9,19,31,28,3,10,17,20,1,0.2,"[0, 20, 40]",0.0005,0.002,0.001,5
5109,0.0012999999999997668,0.5,1,0,3,4,3,1,10,17,20,1,0.2,"[0, 20, 40]",0.0005,0.002,0.0015,1
5110,0.010519999999999655,0.5789473684210527,3,4,12,19,16,3,10,17,20,1,0.2,"[0, 20, 40]",0.0005,0.002,0.0015,3
5111,0.013139999999998679,0.5483870967741935,3,6,22,31,28,3,10,17,20,1,0.2,"[0, 20, 40]",0.0005,0.002,0.0015,5
5112,0.009519999999999659,0.5416666666666666,6,6,12,24,17,7,10,17,20,2,0.1,"[0, 20, 40]",0.0003,0.001,0.001,1
5113,0.020139999999998947,0.559322033898305,14,16,29,59,43,16,10,17,20,2,0.1,"[0, 20, 40]",0.0003,0.001,0.001,3
5114,0.02890999999999872,0.6052631578947368,21,21,34,76,59,17,10,17,20,2,0.1,"[0, 20, 40]",0.0003,0.001,0.001,5
5115,0.011179999999999819,0.5,6,5,13,24,17,7,10,17,20,2,0.1,"[0, 20, 40]",0.0003,0.001,0.0015,1
5116,0.01967999999999903,0.4915254237288136,14,12,33,59,43,16,10,17,20,2,0.1,"[0, 20, 40]",0.0003,0.001,0.0015,3
5117,0.030669999999998948,0.56,22,16,37,75,58,17,10,17,20,2,0.1,"[0, 20, 40]",0.0003,0.001,0.0015,5
5118,0.010139999999999502,0.5416666666666666,2,7,15,24,17,7,10,17,20,2,0.1,"[0, 20, 40]",0.0003,0.0015,0.001,1
5119,0.0193299999999983,0.5254237288135594,4,18,37,59,43,16,10,17,20,2,0.1,"[0, 20, 40]",0.0003,0.0015,0.001,3
5120,0.028349999999997853,0.5733333333333334,8,23,44,75,59,16,10,17,20,2,0.1,"[0, 20, 40]",0.0003,0.0015,0.001,5
5121,0.012299999999999658,0.5,3,5,16,24,17,7,10,17,20,2,0.1,"[0, 20, 40]",0.0003,0.0015,0.0015,1
5122,0.019869999999998392,0.4576271186440678,5,13,41,59,43,16,10,17,20,2,0.1,"[0, 20, 40]",0.0003,0.0015,0.0015,3
5123,0.03160999999999808,0.527027027027027,10,17,47,74,58,16,10,17,20,2,0.1,"[0, 20, 40]",0.0003,0.0015,0.0015,5
5124,0.011139999999999503,0.5416666666666666,2,7,15,24,17,7,10,17,20,2,0.1,"[0, 20, 40]",0.0003,0.002,0.001,1
5125,0.020339999999998255,0.5254237288135594,3,18,38,59,43,16,10,17,20,2,0.1,"[0, 20, 40]",0.0003,0.002,0.001,3
5126,0.02858999999999766,0.5733333333333334,4,23,48,75,59,16,10,17,20,2,0.1,"[0, 20, 40]",0.0003,0.002,0.001,5
5127,0.01379999999999966,0.5,3,5,16,24,17,7,10,17,20,2,0.1,"[0, 20, 40]",0.0003,0.002,0.0015,1
5128,0.02137999999999835,0.4576271186440678,4,13,42,59,43,16,10,17,20,2,0.1,"[0, 20, 40]",0.0003,0.002,0.0015,3
5129,0.03284999999999789,0.527027027027027,6,17,51,74,58,16,10,17,20,2,0.1,"[0, 20, 40]",0.0003,0.002,0.0015,5
5130,0.0064100000000000225,0.8,6,2,2,10,7,3,10,17,20,2,0.1,"[0, 20, 40]",0.0005,0.001,0.001,1
5131,0.01801999999999991,0.8,12,10,8,30,24,6,10,17,20,2,0.1,"[0, 20, 40]",0.0005,0.001,0.001,3
5132,0.025129999999999587,0.7446808510638298,18,13,16,47,41,6,10,17,20,2,0.1,"[0, 20, 40]",0.0005,0.001,0.001,5
5133,0.005269999999999825,0.7,6,1,3,10,7,3,10,17,20,2,0.1,"[0, 20, 40]",0.0005,0.001,0.0015,1
5134,0.0171999999999997,0.7,12,7,11,30,24,6,10,17,20,2,0.1,"[0, 20, 40]",0.0005,0.001,0.0015,3
5135,0.023549999999999287,0.6595744680851063,18,9,20,47,41,6,10,17,20,2,0.1,"[0, 20, 40]",0.0005,0.001,0.0015,5
5136,0.007359999999999866,0.6,1,3,6,10,7,3,10,17,20,2,0.1,"[0, 20, 40]",0.0005,0.0015,0.001,1
5137,0.019939999999999507,0.7333333333333333,4,11,15,30,24,6,10,17,20,2,0.1,"[0, 20, 40]",0.0005,0.0015,0.001,3
5138,0.028809999999998944,0.7021276595744681,8,14,25,47,41,6,10,17,20,2,0.1,"[0, 20, 40]",0.0005,0.0015,0.001,5
5139,0.004399999999999625,0.4,1,1,8,10,7,3,10,17,20,2,0.1,"[0, 20, 40]",0.0005,0.0015,0.0015,1
5140,0.017299999999999247,0.6,4,7,19,30,24,6,10,17,20,2,0.1,"[0, 20, 40]",0.0005,0.0015,0.0015,3
5141,0.025409999999998604,0.5957446808510638,8,9,30,47,41,6,10,17,20,2,0.1,"[0, 20, 40]",0.0005,0.0015,0.0015,5
5142,0.007859999999999865,0.6,1,3,6,10,7,3,10,17,20,2,0.1,"[0, 20, 40]",0.0005,0.002,0.001,1
5143,0.021219999999999455,0.7333333333333333,3,11,16,30,24,6,10,17,20,2,0.1,"[0, 20, 40]",0.0005,0.002,0.001,3
5144,0.029649999999998455,0.7021276595744681,5,14,28,47,41,6,10,17,20,2,0.1,"[0, 20, 40]",0.0005,0.002,0.001,5
5145,0.004899999999999625,0.4,1,1,8,10,7,3,10,17,20,2,0.1,"[0, 20, 40]",0.0005,0.002,0.0015,1
5146,0.018579999999999198,0.6,3,7,20,30,24,6,10,17,20,2,0.1,"[0, 20, 40]",0.0005,0.002,0.0015,3
5147,0.02624999999999811,0.5957446808510638,5,9,33,47,41,6,10,17,20,2,0.1,"[0, 20, 40]",0.0005,0.002,0.0015,5
5148,0.003099999999999767,0.5,3,2,5,10,10,0,10,17,20,2,0.2,"[0, 20, 40]",0.0003,0.001,0.001,1
5149,0.00815999999999994,0.56,4,9,12,25,22,3,10,17,20,2,0.2,"[0, 20, 40]",0.0003,0.001,0.001,3
5150,0.014859999999999842,0.6388888888888888,8,13,15,36,32,4,10,17,20,2,0.2,"[0, 20, 40]",0.0003,0.001,0.001,5
5151,0.004099999999999766,0.5,3,2,5,10,10,0,10,17,20,2,0.2,"[0, 20, 40]",0.0003,0.001,0.0015,1
5152,0.00553999999999987,0.44,4,6,15,25,22,3,10,17,20,2,0.2,"[0, 20, 40]",0.0003,0.001,0.0015,3
5153,0.013739999999999771,0.5555555555555556,9,9,18,36,32,4,10,17,20,2,0.2,"[0, 20, 40]",0.0003,0.001,0.0015,5
5154,0.0032299999999996754,0.5,1,3,6,10,10,0,10,17,20,2,0.2,"[0, 20, 40]",0.0003,0.0015,0.001,1
5155,0.007629999999999801,0.56,0,11,14,25,22,3,10,17,20,2,0.2,"[0, 20, 40]",0.0003,0.0015,0.001,3
5156,0.014749999999999456,0.6388888888888888,2,15,19,36,32,4,10,17,20,2,0.2,"[0, 20, 40]",0.0003,0.0015,0.001,5
5157,0.0047299999999996754,0.5,2,2,6,10,10,0,10,17,20,2,0.2,"[0, 20, 40]",0.0003,0.0015,0.0015,1
5158,0.00600999999999973,0.44,1,7,17,25,22,3,10,17,20,2,0.2,"[0, 20, 40]",0.0003,0.0015,0.0015,3
5159,0.015129999999999384,0.5555555555555556,4,10,22,36,32,4,10,17,20,2,0.2,"[0, 20, 40]",0.0003,0.0015,0.0015,5
5160,0.0037299999999996754,0.5,1,3,6,10,10,0,10,17,20,2,0.2,"[0, 20, 40]",0.0003,0.002,0.001,1
5161,0.007629999999999801,0.56,0,11,14,25,22,3,10,17,20,2,0.2,"[0, 20, 40]",0.0003,0.002,0.001,3
5162,0.014699999999999462,0.6388888888888888,1,15,20,36,32,4,10,17,20,2,0.2,"[0, 20, 40]",0.0003,0.002,0.001,5
5163,0.005729999999999675,0.5,2,2,6,10,10,0,10,17,20,2,0.2,"[0, 20, 40]",0.0003,0.002,0.0015,1
5164,0.0065099999999997295,0.44,1,7,17,25,22,3,10,17,20,2,0.2,"[0, 20, 40]",0.0003,0.002,0.0015,3
5165,0.01607999999999939,0.5555555555555556,3,10,23,36,32,4,10,17,20,2,0.2,"[0, 20, 40]",0.0003,0.002,0.0015,5
5166,0.0014899999999999237,0.6666666666666666,1,1,1,3,3,0,10,17,20,2,0.2,"[0, 20, 40]",0.0005,0.001,0.001,1
5167,0.006719999999999967,0.7142857142857143,2,6,6,14,13,1,10,17,20,2,0.2,"[0, 20, 40]",0.0005,0.001,0.001,3
5168,0.012779999999999785,0.72,6,9,10,25,24,1,10,17,20,2,0.2,"[0, 20, 40]",0.0005,0.001,0.001,5
5169,0.0019899999999999233,0.6666666666666666,1,1,1,3,3,0,10,17,20,2,0.2,"[0, 20, 40]",0.0005,0.001,0.0015,1
5170,0.006039999999999952,0.5714285714285714,2,4,8,14,13,1,10,17,20,2,0.2,"[0, 20, 40]",0.0005,0.001,0.0015,3
5171,0.011339999999999675,0.6,6,6,13,25,24,1,10,17,20,2,0.2,"[0, 20, 40]",0.0005,0.001,0.0015,5
5172,0.00131999999999981,0.6666666666666666,0,1,2,3,3,0,10,17,20,2,0.2,"[0, 20, 40]",0.0005,0.0015,0.001,1
5173,0.007049999999999852,0.7142857142857143,1,6,7,14,13,1,10,17,20,2,0.2,"[0, 20, 40]",0.0005,0.0015,0.001,3
5174,0.013869999999999431,0.72,3,9,13,25,24,1,10,17,20,2,0.2,"[0, 20, 40]",0.0005,0.0015,0.001,5
5175,0.0018199999999998098,0.6666666666666666,0,1,2,3,3,0,10,17,20,2,0.2,"[0, 20, 40]",0.0005,0.0015,0.0015,1
5176,0.006369999999999838,0.5714285714285714,1,4,9,14,13,1,10,17,20,2,0.2,"[0, 20, 40]",0.0005,0.0015,0.0015,3
5177,0.012429999999999317,0.6,3,6,16,25,24,1,10,17,20,2,0.2,"[0, 20, 40]",0.0005,0.0015,0.0015,5
5178,0.00131999999999981,0.6666666666666666,0,1,2,3,3,0,10,17,20,2,0.2,"[0, 20, 40]",0.0005,0.002,0.001,1
5179,0.007549999999999852,0.7142857142857143,1,6,7,14,13,1,10,17,20,2,0.2,"[0, 20, 40]",0.0005,0.002,0.001,3
5180,0.014149999999999212,0.72,2,9,14,25,24,1,10,17,20,2,0.2,"[0, 20, 40]",0.0005,0.002,0.001,5
5181,0.0018199999999998098,0.6666666666666666,0,1,2,3,3,0,10,17,20,2,0.2,"[0, 20, 40]",0.0005,0.002,0.0015,1
5182,0.006869999999999838,0.5714285714285714,1,4,9,14,13,1,10,17,20,2,0.2,"[0, 20, 40]",0.0005,0.002,0.0015,3
5183,0.012709999999999097,0.6,2,6,17,25,24,1,10,17,20,2,0.2,"[0, 20, 40]",0.0005,0.002,0.0015,5
